10,2,0,0,2,5
10,1,0,0,1,5
10,2,0,0,2,5
10,1,0,0,1,5
10,1,0,0,1,5
10,1,0,0,1,5
10,1,0,0,1,5
10,1,0,0,1,5
10,1,0,0,1,5
10,1,0,0,1,5
100,16,4,4,24,11
100,15,4,4,23,11
100,24,6,6,36,11
100,29,6,5,40,11
100,15,4,4,23,11
100,23,6,7,36,11
100,24,10,6,40,11
100,19,4,4,27,11
100,20,4,4,28,11
100,15,4,4,23,11
1000,327,63,52,442,17
1000,201,38,38,277,17
1000,312,70,66,448,17
1000,202,39,40,281,17
1000,310,59,60,429,17
1000,209,46,38,293,17
1000,203,38,39,280,17
1000,203,38,38,279,17
1000,340,65,66,471,17
1000,201,39,39,279,17
10000,2969,383,402,3754,24
10000,2981,384,391,3756,24
10000,2608,392,384,3384,24
10000,2794,388,464,3646,24
10000,3713,386,391,4490,24
10000,2651,478,394,3523,24
10000,3073,385,396,3854,24
10000,2611,455,500,3566,24
10000,3069,576,566,4211,24
10000,3024,486,420,3930,24
100000,36833,3655,3996,44484,31
100000,36227,3603,3721,43551,31
100000,35247,3694,3682,42623,31
100000,37056,3814,4899,45769,27
100000,37849,4020,4357,46226,27
100000,37150,3695,3940,44785,27
100000,35461,3681,3742,42884,27
100000,35480,4033,4797,44310,27
100000,35202,3850,4955,44007,27
100000,36852,4332,3886,45070,29
1000000,484521,34853,34721,554095,20
1000000,482747,32843,33217,548807,24
1000000,446167,32554,33727,512448,28
1000000,468862,33408,33379,535649,22
1000000,444876,35077,33550,513503,26
1000000,442683,32951,35641,511275,23
1000000,452253,32592,33855,518700,24
1000000,458081,35044,41319,534444,20
1000000,479571,36667,43121,559359,21
1000000,468761,35629,40327,544717,30
1000,278,53,53,384,18
1000,476,38,39,553,18
1000,198,38,39,275,18
1000,198,38,39,275,18
1000,199,38,39,276,18
1500,308,58,59,425,18
1500,316,58,59,433,18
1500,519,68,60,647,18
1500,330,58,59,447,18
1500,310,58,60,428,18
2000,458,130,83,671,19
2000,439,76,79,594,19
2000,431,76,81,588,19
2000,672,76,80,828,19
2000,432,76,80,588,19
2500,557,96,100,753,21
2500,749,113,99,961,21
2500,910,170,167,1247,21
2500,775,131,134,1040,21
2500,557,96,98,751,21
3000,731,116,214,1061,21
3000,687,115,269,1071,21
3000,687,116,119,922,21
3000,688,117,121,926,21
3000,929,127,204,1260,21
3500,816,135,138,1089,21
3500,1241,201,216,1658,21
3500,1096,135,138,1369,21
3500,802,140,158,1100,21
3500,806,134,136,1076,21
4000,1157,153,157,1467,22
4000,969,153,160,1282,22
4000,1072,162,154,1388,22
4000,936,153,157,1246,22
4000,940,153,156,1249,22
4500,1071,172,173,1416,22
4500,1064,185,303,1552,22
4500,1162,172,173,1507,22
4500,1081,178,174,1433,22
4500,1067,172,177,1416,22
5000,1668,193,193,2054,22
5000,2095,280,283,2658,22
5000,1567,273,279,2119,22
5000,1201,192,223,1616,22
5000,1232,192,309,1733,22
5500,1342,217,212,1771,25
5500,1332,211,276,1819,25
5500,1566,210,212,1988,25
5500,1337,216,213,1766,25
5500,1331,211,213,1755,25
6000,1535,278,234,2047,25
6000,1467,232,231,1930,25
6000,1464,490,313,2267,25
6000,1886,328,299,2513,25
6000,1471,238,232,1941,25
6500,1608,250,331,2189,26
6500,1616,252,251,2119,26
6500,1613,254,281,2148,26
6500,1618,250,250,2118,26
6500,1611,255,250,2116,26
7000,1941,270,270,2481,26
7000,2142,384,269,2795,26
7000,1740,269,270,2279,26
7000,1871,270,270,2411,26
7000,1737,268,275,2280,26
7500,1893,289,289,2471,28
7500,2551,287,294,3132,28
7500,1892,389,363,2644,28
7500,1939,290,293,2522,21
7500,1987,288,302,2577,21
8000,2235,435,722,3392,21
8000,2049,306,323,2678,21
8000,2061,306,314,2681,21
8000,2642,336,324,3302,21
8000,2010,307,314,2631,21
8500,2371,477,480,3328,19
8500,2599,330,357,3286,19
8500,2153,335,360,2848,19
8500,2395,329,336,3060,19
8500,2194,350,516,3060,19
9000,2356,350,352,3058,20
9000,2896,452,357,3705,20
9000,2810,343,359,3512,20
9000,2315,346,417,3078,20
9000,2332,345,354,3031,20
9500,2668,377,374,3419,18
9500,2464,525,492,3481,18
9500,2682,363,373,3418,18
9500,2615,366,378,3359,18
9500,2446,434,635,3515,18
10000,2614,384,478,3476,18
10000,2572,383,393,3348,18
10000,3026,382,402,3810,18
10000,2582,383,395,3360,18
10000,2812,386,397,3595,18
10500,2753,406,409,3568,18
10500,3998,406,418,4822,18
10500,2702,406,431,3539,18
10500,2702,410,413,3525,18
10500,3135,422,417,3974,18
11000,2977,424,431,3832,19
11000,3121,423,449,3993,19
11000,3108,424,455,3987,19
11000,3425,430,442,4297,19
11000,2995,430,438,3863,19
11500,3607,441,452,4500,19
11500,3027,441,450,3918,19
11500,3238,442,455,4135,19
11500,3051,442,455,3948,19
11500,3553,449,454,4456,19
12000,3278,605,586,4469,21
12000,3162,497,641,4300,21
12000,3649,475,474,4598,21
12000,3989,474,473,4936,21
12000,3152,466,473,4091,21
12500,3643,479,492,4614,21
12500,3357,485,493,4335,21
12500,3360,572,647,4579,21
12500,4739,606,489,5834,26
12500,4995,498,505,5998,26
13000,3867,519,512,4898,26
13000,3614,496,622,4732,26
13000,3488,498,511,4497,26
13000,3559,503,508,4570,26
13000,3473,505,621,4599,26
13500,3751,747,825,5323,28
13500,4106,526,528,5160,28
13500,3939,518,527,4984,28
13500,3690,652,537,4879,28
13500,3632,519,714,4865,28
14000,3818,540,551,4909,28
14000,5132,940,763,6835,28
14000,5122,534,577,6233,28
14000,3929,557,551,5037,28
14000,4484,542,545,5571,28
14500,3950,556,573,5079,28
14500,4025,564,577,5166,28
14500,3921,560,1022,5503,28
14500,3952,564,693,5209,28
14500,5315,620,657,6592,28
15000,4089,598,624,5311,28
15000,4061,705,586,5352,28
15000,4261,583,583,5427,28
15000,4093,612,592,5297,28
15000,4122,582,595,5299,28
15500,4697,589,608,5894,28
15500,4217,595,606,5418,28
15500,5861,604,700,7165,28
15500,4581,596,607,5784,28
15500,4334,601,605,5540,28
16000,4636,615,621,5872,28
16000,4370,615,623,5608,28
16000,4613,616,644,5873,23
16000,4968,616,634,6218,23
16000,4595,634,627,5856,23
16500,4930,632,660,6222,23
16500,4929,760,657,6346,23
16500,4513,634,768,5915,23
16500,4557,633,686,5876,23
16500,4572,636,832,6040,23
17000,4830,1080,719,6629,23
17000,7210,932,943,9085,23
17000,4737,651,669,6057,23
17000,5020,652,661,6333,23
17000,5945,842,695,7482,23
17500,4934,675,891,6500,23
17500,4910,674,674,6258,23
17500,5214,668,678,6560,23
17500,4805,673,672,6150,23
17500,4817,875,671,6363,23
18000,5277,694,691,6662,23
18000,5232,692,805,6729,23
18000,5098,958,806,6862,23
18000,5598,738,692,7028,23
18000,5003,698,691,6392,23
18500,5278,712,772,6762,23
18500,5276,711,712,6699,23
18500,5837,711,713,7261,23
18500,5698,713,716,7127,23
18500,5248,940,832,7020,23
19000,5951,726,766,7443,23
19000,6158,726,735,7619,23
19000,5610,735,734,7079,23
19000,5657,731,769,7157,23
19000,5386,735,772,6893,23
19500,5950,1023,791,7764,23
19500,5482,745,760,6987,22
19500,6260,785,758,7803,22
19500,6267,860,763,7890,22
19500,6485,824,807,8116,22
20000,6384,806,774,7964,23
20000,6088,767,783,7638,23
20000,6946,797,787,8530,23
20000,5774,775,780,7329,23
20000,5826,796,780,7402,23
20500,5949,789,815,7553,23
20500,6008,1084,811,7903,23
20500,7530,1205,1044,9779,23
20500,6020,787,810,7617,23
20500,6141,786,795,7722,23
21000,5953,809,819,7581,24
21000,6004,852,914,7770,24
21000,6216,821,819,7856,24
21000,6799,806,835,8440,24
21000,6214,802,858,7874,24
21500,6387,889,836,8112,25
21500,6102,826,833,7761,25
21500,6098,824,847,7769,25
21500,6116,852,833,7801,25
21500,6451,847,834,8132,25
22000,6390,846,860,8096,25
22000,9335,1083,893,11311,25
22000,6450,1184,881,8515,25
22000,6337,849,856,8042,25
22000,6366,845,876,8087,25
22500,7221,871,873,8965,30
22500,7076,863,874,8813,30
22500,6865,865,871,8601,30
22500,6696,933,872,8501,30
22500,6857,862,923,8642,30
23000,7025,957,916,8898,30
23000,6727,883,904,8514,30
23000,6663,882,895,8440,30
23000,6576,882,893,8351,30
23000,6835,1007,913,8755,30
23500,6800,926,913,8639,31
23500,8113,904,916,9933,31
23500,6976,902,997,8875,31
23500,6831,953,970,8754,31
23500,7042,905,933,8880,31
24000,7230,923,930,9083,31
24000,7176,926,934,9036,31
24000,6864,925,937,8726,31
24000,7372,923,956,9251,31
24000,7188,922,934,9044,31
24500,7402,1075,957,9434,30
24500,7178,967,959,9104,30
24500,7395,935,950,9280,30
24500,7577,958,1070,9605,25
24500,7892,968,962,9822,25
25000,7380,962,978,9320,25
25000,7603,962,1001,9566,25
25000,7480,1182,1121,9783,25
25000,8236,1069,988,10293,25
25000,7461,1070,1002,9533,25
25500,7569,980,995,9544,25
25500,7505,979,990,9474,25
25500,7546,981,989,9516,25
25500,7840,998,991,9829,25
25500,8050,980,995,10025,25
26000,8473,992,1008,10473,25
26000,8251,1000,1013,10264,25
26000,9534,996,1213,11743,25
26000,8257,994,1076,10327,25
26000,9057,1070,1225,11352,25
26500,7920,1065,1031,10016,25
26500,7555,985,1000,9540,25
26500,7662,1011,998,9671,25
26500,8026,988,999,10013,25
26500,9783,1234,1247,12264,25
27000,11466,1525,1330,14321,25
27000,10188,1340,1272,12800,29
27000,9915,1258,1584,12757,29
27000,10162,1834,1726,13722,29
27000,11465,1197,1049,13711,29
27500,9209,1030,1227,11466,28
27500,9118,1288,1038,11444,28
27500,9678,1298,1449,12425,28
27500,9824,1430,1553,12807,28
27500,8572,1039,1069,10680,28
28000,8144,1052,1069,10265,28
28000,7957,1044,1263,10264,28
28000,9359,1058,1070,11487,28
28000,9587,1044,1057,11688,28
28000,8556,1039,1058,10653,28
28500,8945,1387,1334,11666,28
28500,8611,1062,1074,10747,28
28500,9878,1098,1126,12102,28
28500,10080,1091,1464,12635,28
28500,8615,1059,1083,10757,28
29000,8479,1079,1100,10658,27
29000,10961,1319,1159,13439,27
29000,8742,1076,1210,11028,27
29000,9974,1317,1166,12457,27
29000,9333,1597,1740,12670,27
29500,10006,1174,1143,12323,27
29500,11539,1644,1898,15081,27
29500,10442,1566,1433,13441,27
29500,10298,1132,1142,12572,27
29500,9911,1224,1377,12512,27
30000,10703,1129,1173,13005,27
30000,9048,1149,1340,11537,27
30000,8844,1307,1168,11319,27
30000,8794,1165,1178,11137,27
30000,8795,1136,1176,11107,27
30500,9881,1178,1398,12457,27
30500,8925,1232,1182,11339,27
30500,9297,1170,1219,11686,27
30500,9077,1165,1203,11445,27
30500,9956,1166,1238,12360,27
31000,11322,1185,1209,13716,22
31000,10101,1187,1215,12503,22
31000,10025,1210,1196,12431,22
31000,9414,1290,1200,11904,22
31000,9557,1200,1242,11999,22
31500,9507,1195,1213,11915,22
31500,9970,1220,1215,12405,22
31500,9680,1203,1218,12101,22
31500,9479,1205,1291,11975,22
31500,9446,1200,1213,11859,22
32000,9506,1238,1240,11984,22
32000,10937,1252,1566,13755,22
32000,10151,1218,1236,12605,22
32000,9814,1223,1234,12271,22
32000,10111,1218,1616,12945,22
32500,10247,1240,1251,12738,22
32500,10654,1246,1255,13155,22
32500,10130,1469,1254,12853,22
32500,9687,1243,1257,12187,22
32500,9820,1241,1255,12316,22
33000,10218,1257,1269,12744,22
33000,10081,1311,1322,12714,27
33000,10157,1272,1425,12854,27
33000,10559,1458,1312,13329,27
33000,10447,1262,1268,12977,27
33500,10204,1277,1317,12798,27
33500,10361,1278,1496,13135,27
33500,10402,1272,1288,12962,27
33500,10183,1306,1287,12776,27
33500,11262,1755,1307,14324,27
34000,12608,1370,1391,15369,27
34000,10966,1305,1311,13582,27
34000,10737,1300,1320,13357,27
34000,11216,1306,2100,14622,27
34000,10522,1705,1641,13868,27
34500,10913,1333,1747,13993,27
34500,10645,1315,1332,13292,27
34500,10335,1317,1323,12975,27
34500,10481,1378,1950,13809,27
34500,11032,1318,1339,13689,29
35000,12708,1333,1344,15385,30
35000,10560,1394,1353,13307,30
35000,10916,1362,1361,13639,30
35000,10656,1379,1353,13388,30
35000,10571,1361,1341,13273,30
35500,11216,1451,1370,14037,30
35500,10668,1355,1369,13392,30
35500,11242,1355,1376,13973,30
35500,15709,1698,1482,18889,30
35500,10992,1447,1582,14021,30
36000,11355,1378,1389,14122,30
36000,11136,1538,1385,14059,30
36000,11327,1372,1402,14101,30
36000,10956,1549,1391,13896,30
36000,11780,1370,1390,14540,30
36500,11959,1389,1840,15188,31
36500,11203,1920,1392,14515,21
36500,11529,1390,1397,14316,21
36500,12250,1392,1391,15033,21
36500,11548,1407,1543,14498,21
37000,12024,1506,1416,14946,21
37000,11514,1410,1427,14351,21
37000,11873,1406,1516,14795,21
37000,11481,1435,2186,15102,21
37000,11579,1548,1430,14557,21
37500,12013,1434,1441,14888,20
37500,11796,1437,1945,15178,20
37500,12198,2356,1437,15991,20
37500,12223,1432,1451,15106,20
37500,11891,1464,1461,14816,20
38000,11494,1447,1458,14399,20
38000,11553,1440,1462,14455,20
38000,11713,1440,1458,14611,20
38000,15797,1999,2218,20014,20
38000,13119,1548,1456,16123,20
38500,11707,1459,2101,15267,25
38500,11921,1652,1628,15201,25
38500,11974,1483,1476,14933,25
38500,12269,1464,1501,15234,25
38500,11700,1489,1486,14675,25
39000,12055,1465,1557,15077,25
39000,12108,1480,1601,15189,25
39000,12067,1519,1609,15195,25
39000,11920,2143,1632,15695,25
39000,12047,1480,1502,15029,25
39500,12468,1514,1512,15494,25
39500,12141,1526,1515,15182,25
39500,12845,1609,1525,15979,25
39500,12695,1498,1513,15706,25
39500,13014,1497,1568,16079,25
40000,13005,1521,1551,16077,22
40000,12350,1508,1537,15395,22
40000,12095,1524,1533,15152,31
40000,12519,1846,1579,15944,31
40000,13593,1639,1566,16798,31
40500,12269,1566,1560,15395,31
40500,12728,1535,1551,15814,31
40500,12877,1594,1588,16059,31
40500,12541,1551,1547,15639,31
40500,12243,1552,1573,15368,31
41000,12930,1564,1598,16092,30
41000,12893,1560,1590,16043,30
41000,13215,1592,1601,16408,30
41000,14187,1559,1571,17317,30
41000,13648,1562,1570,16780,30
41500,13665,1575,1586,16826,30
41500,13152,1576,1607,16335,30
41500,13603,1583,2012,17198,30
41500,13084,1582,1590,16256,30
41500,13181,1592,1591,16364,30
42000,13001,1588,1671,16260,30
42000,13148,1591,1875,16614,30
42000,13422,1806,1683,16911,30
42000,13345,1594,1603,16542,30
42000,13390,1595,1608,16593,30
42500,13616,1874,1673,17163,30
42500,13149,1620,1633,16402,30
42500,13867,1808,1623,17298,30
42500,13773,1899,2213,17885,30
42500,13338,1667,1633,16638,30
43000,13567,1638,1661,16866,31
43000,13467,1642,1649,16758,35
43000,13494,1804,1656,16954,35
43000,13064,1636,1701,16401,35
43000,13093,1638,1640,16371,35
43500,14021,1646,1665,17332,35
43500,13734,1643,1661,17038,35
43500,13933,1662,1658,17253,35
43500,13870,1651,1656,17177,35
43500,13326,1677,1666,16669,35
44000,13528,1676,1707,16911,35
44000,14308,1697,1940,17945,35
44000,17217,1664,2074,20955,35
44000,13796,2423,1677,17896,35
44000,14095,1712,1694,17501,27
44500,14745,1688,1886,18319,27
44500,15263,1681,1701,18645,27
44500,14565,1682,1708,17955,27
44500,14381,1691,1852,17924,27
44500,14132,1832,1805,17769,27
45000,14214,1924,1717,17855,27
45000,14257,1792,1780,17829,27
45000,14324,1700,1845,17869,27
45000,14793,1712,1723,18228,27
45000,13917,1703,1722,17342,27
45500,15126,1728,1746,18600,28
45500,15567,1947,1839,19353,28
45500,14939,1759,1815,18513,28
45500,14247,1746,1759,17752,28
45500,14867,1777,1979,18623,31
46000,14406,1776,1846,18028,31
46000,14863,1846,1761,18470,31
46000,15053,1742,1927,18722,31
46000,14639,1899,1766,18304,31
46000,14908,1739,1774,18421,31
46500,15019,1759,1878,18656,31
46500,16878,2610,2603,22091,31
46500,18939,1781,1813,22533,31
46500,19445,2130,2395,23970,31
46500,18755,2330,2287,23372,31
47000,15255,1785,1914,18954,31
47000,18056,1736,1742,21534,25
47000,15019,1876,1842,18737,25
47000,14872,1734,1927,18533,25
47000,29987,3189,3192,36368,25
47500,20126,2182,2233,24541,25
47500,16701,1839,1788,20328,25
47500,15236,1856,1785,18877,25
47500,14719,1937,2573,19229,25
47500,14791,1750,1990,18531,25
48000,14707,1805,1785,18297,25
48000,15038,1940,2430,19408,25
48000,17007,1869,1800,20676,26
48000,14536,2506,2455,19497,26
48000,17687,1811,1826,21324,26
48500,15600,1796,1820,19216,26
48500,14870,1784,1805,18459,26
48500,15929,1863,1991,19783,26
48500,15703,1817,1872,19392,26
48500,15578,1834,1838,19250,26
49000,14886,1808,2030,18724,26
49000,15461,1880,1893,19234,26
49000,15537,1877,1888,19302,26
49000,15542,1857,1866,19265,26
49000,16088,2218,1944,20250,26
49500,15659,1872,1909,19440,26
49500,15785,1922,1884,19591,21
49500,16273,1879,2151,20303,21
49500,15455,1886,1878,19219,21
49500,16402,1866,1898,20166,21
50000,16927,1915,1901,20743,21
50000,16324,1888,1932,20144,21
50000,15603,1905,1900,19408,21
50000,15921,1992,1905,19818,21
50000,16216,1886,2229,20331,21
50500,16230,1918,1915,20063,21
50500,17337,1950,1949,21236,21
50500,15952,1904,1925,19781,21
50500,16149,1904,2008,20061,21
50500,16544,2003,2003,20550,21
51000,16170,1928,1930,20028,21
51000,16672,1934,1971,20577,26
51000,16959,1922,2025,20906,26
51000,16390,1919,1930,20239,26
51000,16885,1950,1936,20771,26
51500,16547,1992,2155,20694,25
51500,16171,1933,2146,20250,25
51500,15965,1941,1957,19863,25
51500,16317,1960,1971,20248,25
51500,16080,1939,1979,19998,25
52000,16814,1964,1971,20749,25
52000,16865,1979,1974,20818,25
52000,17184,1954,2060,21198,25
52000,16759,2067,1980,20806,25
52000,16415,1953,2658,21026,33
52500,16733,1987,2029,20749,32
52500,16987,2012,2079,21078,32
52500,16614,2014,1999,20627,32
52500,16397,2003,1996,20396,32
52500,16870,1988,1985,20843,32
53000,17355,2070,2001,21426,32
53000,17465,2002,2028,21495,32
53000,16800,2013,2009,20822,32
53000,17014,2024,2020,21058,32
53000,17231,1997,2177,21405,32
53500,17021,2050,2060,21131,33
53500,17608,2040,2029,21677,30
53500,19121,2210,2197,23528,30
53500,18269,2049,2036,22354,30
53500,17552,2124,2126,21802,30
54000,17905,2046,2042,21993,30
54000,17637,2047,2343,22027,30
54000,18139,2037,2054,22230,30
54000,17509,2083,2050,21642,30
54000,17554,2042,2060,21656,30
54500,17526,2120,2228,21874,30
54500,17792,2058,2084,21934,30
54500,18418,2211,2412,23041,27
54500,17510,2069,2116,21695,27
54500,17597,2056,2055,21708,27
55000,18862,2076,2134,23072,27
55000,19725,2062,2074,23861,27
55000,17310,2218,2108,21636,27
55000,17659,2340,2445,22444,27
55000,18043,2230,2202,22475,27
55500,19231,2140,2111,23482,27
55500,19554,2186,2193,23933,27
55500,18889,2073,2093,23055,27
55500,17579,2103,2090,21772,27
55500,19075,2080,2086,23241,30
56000,19486,2112,2126,23724,29
56000,23420,2405,2290,28115,29
56000,18349,2138,2130,22617,29
56000,18132,2104,2226,22462,29
56000,18019,2096,2118,22233,29
56500,18565,2128,2141,22834,29
56500,18507,2121,2227,22855,29
56500,18537,2365,2210,23112,29
56500,17732,2121,2139,21992,29
56500,18578,3247,2137,23962,29
57000,19482,2170,2278,23930,26
57000,19277,2160,2158,23595,26
57000,19574,2192,2307,24073,26
57000,18839,2129,2282,23250,26
57000,19617,2517,2331,24465,26
57500,19003,2146,2195,23344,26
57500,18366,2203,2334,22903,26
57500,18248,2153,2363,22764,26
57500,18099,2154,2177,22430,26
57500,18098,2273,2186,22557,26
58000,18282,2211,2182,22675,26
58000,19185,2172,2208,23565,26
58000,18808,2207,2188,23203,33
58000,19410,2181,2275,23866,33
58000,19747,2172,2276,24195,33
58500,18759,2206,2204,23169,34
58500,18681,2245,2238,23164,34
58500,18647,2184,2325,23156,34
58500,18835,2300,2274,23409,34
58500,18764,2206,2209,23179,34
59000,19459,2463,2273,24195,34
59000,19123,2300,2242,23665,34
59000,18700,2369,2226,23295,27
59000,18807,2251,2226,23284,27
59000,19705,2235,2308,24248,27
59500,19963,2487,2261,24711,27
59500,19037,2240,2294,23571,27
59500,19659,2344,2235,24238,27
59500,20204,2237,2258,24699,27
59500,19469,2311,2237,24017,27
60000,19837,2238,2282,24357,28
60000,20263,2422,2289,24974,28
60000,19001,2268,2376,23645,28
60000,19376,2272,2300,23948,25
60000,19382,2241,2346,23969,25
60500,20252,2643,2278,25173,25
60500,20429,2265,2379,25073,25
60500,19753,2278,2952,24983,25
60500,19343,2294,2305,23942,25
60500,19897,2488,2342,24727,25
61000,19779,2296,2286,24361,25
61000,19465,2293,2320,24078,25
61000,20110,2437,2506,25053,25
61000,19253,2286,2309,23848,25
61000,21511,2605,2295,26411,33
61500,19617,2320,2313,24250,33
61500,19593,2282,2333,24208,33
61500,19872,2300,2319,24491,33
61500,19757,2292,2352,24401,33
61500,19722,2332,2312,24366,33
62000,20451,2312,2332,25095,34
62000,20542,2354,2325,25221,34
62000,19910,2324,2333,24567,34
62000,22317,2383,2443,27143,34
62000,20932,2317,2338,25587,28
62500,20214,2356,2348,24918,28
62500,20638,2516,2363,25517,28
62500,20888,2395,2474,25757,28
62500,20880,2477,2381,25738,28
62500,21157,2328,2910,26395,28
63000,20803,2634,2417,25854,28
63000,20700,2406,2366,25472,28
63000,20512,2355,2546,25413,28
63000,20739,2347,2387,25473,28
63000,20873,2377,2377,25627,28
63500,21196,2364,2517,26077,29
63500,20491,2380,2370,25241,29
63500,20559,2378,2473,25410,29
63500,21221,2387,2410,26018,29
63500,20987,2404,2546,25937,29
64000,20385,2425,2461,25271,29
64000,20294,2406,2413,25113,29
64000,21351,2545,2441,26337,29
64000,21069,2390,2457,25916,29
64000,20261,2570,2434,25265,29
64500,20817,2555,2413,25785,29
64500,21076,2410,2423,25909,29
64500,20445,2433,2424,25302,29
64500,20818,2407,2421,25646,29
64500,20807,2417,2462,25686,29
65000,20794,2423,2912,26129,29
65000,21220,2443,2433,26096,29
65000,21004,2445,2436,25885,29
65000,21224,2467,2439,26130,29
65000,24852,2465,2535,29852,29
65500,21381,2477,2522,26380,30
65500,20876,2438,2470,25784,30
65500,20864,2453,2458,25775,30
65500,26428,3697,3906,34031,30
65500,22143,2497,2468,27108,30
66000,22396,3320,3656,29372,30
66000,23782,15355,3711,42848,30
66000,24901,2877,2722,30500,30
66000,22132,3477,2863,28472,30
66000,27077,2475,2524,32076,26
66500,21579,2466,3429,27474,26
66500,27549,3940,3064,34553,26
66500,25296,3110,2788,31194,26
66500,23591,2897,2475,28963,26
66500,21401,2448,2444,26293,26
67000,21933,2501,2501,26935,26
67000,22553,2512,2550,27615,26
67000,21662,2594,2647,26903,26
67000,22882,2497,2512,27891,28
67000,22272,2498,2497,27267,28
67500,22124,2535,2518,27177,28
67500,25877,3253,3254,32384,28
67500,24118,2454,2647,29219,28
67500,30837,4982,3263,39082,28
67500,24532,2489,2490,29511,28
68000,28396,3206,3181,34783,29
68000,24452,4055,2636,31143,29
68000,31076,3610,2749,37435,24
68000,25420,2533,2516,30469,24
68000,23035,2624,2600,28259,24
68500,23330,2527,3879,29736,24
68500,23172,2498,2611,28281,24
68500,22803,2547,2515,27865,24
68500,21739,2746,2935,27420,24
68500,22304,2714,2554,27572,24
69000,22214,2797,3147,28158,24
69000,26051,3531,3026,32608,24
69000,22229,2524,2676,27429,27
69000,23658,2539,2538,28735,27
69000,21740,2819,4125,28684,27
69500,23125,2530,2547,28202,27
69500,29132,2534,2589,34255,27
69500,27177,3663,3304,34144,27
69500,22159,2533,3483,28175,27
69500,22532,2573,2546,27651,27
70000,22257,2532,2560,27349,27
70000,23910,2547,2665,29122,27
70000,24171,3175,3446,30792,28
70000,23982,2533,2672,29187,28
70000,22161,2569,2557,27287,28
70500,23048,2854,2645,28547,29
70500,23506,2606,2620,28732,29
70500,23103,2624,2631,28358,29
70500,22803,2629,2659,28091,29
70500,23066,2796,2653,28515,29
71000,23961,2631,2993,29585,29
71000,23365,3360,2686,29411,29
71000,23517,2673,2667,28857,29
71000,24040,2619,2669,29328,29
71000,23761,2636,3011,29408,29
71500,23320,2647,3026,28993,29
71500,25085,2698,2764,30547,29
71500,24583,2676,2671,29930,29
71500,24489,2715,2826,30030,29
71500,23260,2660,2801,28721,29
72000,23462,2668,2670,28800,29
72000,26344,3959,3976,34279,29
72000,23774,2796,2776,29346,29
72000,24169,2668,2730,29567,29
72000,23775,2661,2749,29185,29
72500,23855,2786,2721,29362,29
72500,24598,2687,2852,30137,29
72500,24187,2731,2696,29614,29
72500,24174,2676,2718,29568,29
72500,23113,2651,2642,28406,32
73000,23408,2707,2672,28787,32
73000,23429,2643,2687,28759,32
73000,26537,3327,2989,32853,32
73000,23892,2680,2664,29236,32
73000,23355,2671,2669,28695,32
73500,24120,2656,2669,29445,32
73500,27326,2693,2754,32773,32
73500,24791,2736,2794,30321,32
73500,24138,2722,3348,30208,24
73500,24851,2761,2782,30394,24
74000,24945,2787,2792,30524,24
74000,24425,2799,3354,30578,24
74000,24712,2752,2775,30239,24
74000,24764,2755,2772,30291,24
74000,24132,2738,2745,29615,24
74500,24634,2752,2777,30163,24
74500,24039,2755,3132,29926,24
74500,24072,2749,2805,29626,35
74500,24533,2771,2772,30076,35
74500,24527,2762,2765,30054,35
75000,25074,2775,2822,30671,35
75000,24547,2757,2943,30247,35
75000,25985,2811,2824,31620,35
75000,24968,4009,4351,33328,35
75000,24363,2787,2780,29930,35
75500,24445,2998,2803,30246,28
75500,24530,3314,2799,30643,28
75500,24797,2797,2793,30387,28
75500,24375,2808,2812,29995,28
75500,25144,2817,2851,30812,28
76000,25308,2860,3346,31514,28
76000,24849,2818,3167,30834,28
76000,25819,2892,2818,31529,28
76000,24697,2818,2822,30337,28
76000,24860,2801,2981,30642,33
76500,25015,2795,2838,30648,33
76500,24989,2773,3253,31015,33
76500,24648,2763,3523,30934,33
76500,24927,2765,2769,30461,33
76500,27562,4862,4280,36704,33
77000,24744,2782,2878,30404,33
77000,27825,3393,3065,34283,33
77000,24718,2795,2798,30311,23
77000,25754,2842,2984,31580,23
77000,25130,3220,2867,31217,23
77500,26314,3146,3250,32710,23
77500,25137,3583,3650,32370,23
77500,26652,3033,2897,32582,23
77500,25933,2921,3336,32190,23
77500,27017,2908,2940,32865,23
78000,26317,2920,2885,32122,23
78000,25775,2864,3007,31646,23
78000,27941,2909,2979,33829,30
78000,25533,3042,2895,31470,30
78000,26263,2871,3550,32684,30
78500,25749,3022,2887,31658,30
78500,26694,2962,2979,32635,30
78500,26073,3070,2907,32050,30
78500,26067,3287,2951,32305,30
78500,26075,2977,2907,31959,30
79000,26655,2956,2943,32554,35
79000,27076,2955,2928,32959,35
79000,26269,2947,2933,32149,35
79000,36794,4153,4264,45211,35
79000,30776,4088,4211,39075,35
79500,27990,3142,3011,34143,35
79500,26011,2946,3032,31989,35
79500,26075,2944,2944,31963,28
79500,26354,2942,2945,32241,28
79500,26572,2964,2926,32462,28
80000,26862,3065,2994,32921,28
80000,26758,2933,3009,32700,28
80000,27151,2958,2998,33107,28
80000,30247,3067,3234,36548,28
80000,26557,3291,2935,32783,28
80500,26905,3186,3076,33167,30
80500,27904,3132,2974,34010,30
80500,26382,2966,3124,32472,30
80500,27624,2968,3006,33598,30
80500,27504,2954,3001,33459,30
81000,26879,2979,2972,32830,30
81000,28217,2984,3133,34334,30
81000,28627,2975,3446,35048,30
81000,28202,3101,2991,34294,27
81000,26959,2980,3054,32993,27
81500,27590,3010,3039,33639,27
81500,27740,2975,3063,33778,27
81500,27214,2993,2999,33206,27
81500,26781,2995,3028,32804,27
81500,27412,3223,3078,33713,27
82000,27652,3007,3049,33708,27
82000,27684,3061,3033,33778,27
82000,26728,2999,3021,32748,31
82000,27518,3003,3093,33614,31
82000,27051,3080,3026,33157,31
82500,27171,3093,3107,33371,31
82500,27845,3026,3046,33917,31
82500,28300,3438,3103,34841,31
82500,27380,3209,3154,33743,31
82500,27715,3019,3091,33825,31
83000,28758,3436,3050,35244,28
83000,27914,3022,3081,34017,28
83000,27323,3041,3097,33461,28
83000,27926,3069,3055,34050,28
83000,27057,3042,3080,33179,28
83500,27656,3176,3118,33950,28
83500,28232,3061,3073,34366,28
83500,28089,3068,3087,34244,28
83500,27985,3079,3066,34130,31
83500,27678,3138,3086,33902,31
84000,27890,3066,3098,34054,31
84000,29139,3068,3191,35398,31
84000,30976,3178,3092,37246,31
84000,29433,3095,3114,35642,31
84000,28721,3123,3107,34951,31
84500,28187,3103,3157,34447,27
84500,28704,3242,3194,35140,27
84500,27689,3099,3120,33908,27
84500,29360,3303,3133,35796,27
84500,27830,3451,3175,34456,27
85000,28972,3113,3262,35347,27
85000,29357,3324,3494,36175,27
85000,28422,3125,3156,34703,27
85000,29303,3514,3693,36510,34
85000,28988,3154,3116,35258,34
85500,28880,3141,3299,35320,34
85500,28647,3148,3137,34932,34
85500,29657,3767,3307,36731,34
85500,28762,3328,3138,35228,34
85500,28730,3348,3155,35233,34
86000,29137,3151,3198,35486,34
86000,28503,3151,3181,34835,27
86000,33574,3440,3389,40403,27
86000,28329,3164,3206,34699,27
86000,29370,3161,3182,35713,27
86500,30119,3226,3231,36576,27
86500,30067,3222,3177,36466,27
86500,29474,3198,3170,35842,27
86500,29294,3728,3170,36192,27
86500,28837,3255,3189,35281,27
87000,28830,3231,3189,35250,27
87000,30020,3168,3230,36418,27
87000,29445,3205,3229,35879,27
87000,28939,3251,3338,35528,27
87000,29144,3179,3377,35700,27
87500,29253,3201,3330,35784,27
87500,30057,3189,3264,36510,33
87500,29695,3441,3259,36395,33
87500,29689,3269,3220,36178,33
87500,30277,3534,3187,36998,33
88000,30139,3460,3342,36941,33
88000,29467,3299,3220,35986,33
88000,29517,3249,3232,35998,33
88000,29521,3199,3229,35949,22
88000,29212,3206,3246,35664,22
88500,29635,3247,3262,36144,22
88500,29661,5214,3673,38548,22
88500,30335,3230,3641,37206,22
88500,31874,3282,3652,38808,22
88500,29411,3250,3251,35912,22
89000,30749,3242,3271,37262,22
89000,30304,3247,3295,36846,22
89000,29650,3394,3254,36298,29
89000,29368,3286,3266,35920,29
89000,30374,3275,3263,36912,29
89500,31378,3245,3485,38108,29
89500,29887,3308,3278,36473,29
89500,29705,3599,3300,36604,29
89500,29479,3264,3455,36198,29
89500,29514,3256,3424,36194,29
90000,30310,3281,3296,36887,29
90000,29901,3557,3298,36756,29
90000,30284,3326,3322,36932,29
90000,30546,3351,3338,37235,29
90000,30494,3308,3304,37106,29
90500,30496,3304,3305,37105,29
90500,30465,3307,3313,37085,29
90500,30135,3295,3330,36760,30
90500,29741,3285,3307,36333,30
90500,31108,3964,3685,38757,30
91000,31148,3301,3341,37790,31
91000,31828,3724,3835,39387,31
91000,30904,3351,4255,38510,31
91000,30998,3560,3445,38003,31
91000,32417,3370,3491,39278,34
91500,32372,3365,3600,39337,34
91500,31375,3602,3587,38564,34
91500,30716,3320,3371,37407,34
91500,30633,3412,3353,37398,34
91500,31955,3699,3324,38978,34
92000,31269,3439,3527,38235,26
92000,30886,3753,3370,38009,26
92000,30520,3335,3391,37246,26
92000,31849,3381,3657,38887,26
92000,30416,3801,3781,37998,26
92500,32462,3440,3395,39297,26
92500,34596,3711,3877,42184,26
92500,30676,3377,3404,37457,26
92500,33293,3579,3408,40280,32
92500,33223,3563,3377,40163,32
93000,32639,5521,3717,41877,31
93000,31728,4131,4219,40078,31
93000,33910,3645,3479,41034,31
93000,39644,4337,4226,48207,31
93000,31681,3810,3466,38957,31
93500,40577,4208,4324,49109,31
93500,32379,3356,3398,39133,31
93500,32587,3366,3533,39486,31
93500,34284,4288,4339,42911,31
93500,31725,3323,3684,38732,31
94000,34421,4275,4353,43049,31
94000,32179,3515,3431,39125,24
94000,38068,3746,3808,45622,24
94000,30983,3382,3361,37726,24
94000,31482,3707,4625,39814,24
94500,30859,3363,3422,37644,24
94500,31787,3469,3472,38728,24
94500,31173,3823,4130,39126,24
94500,32108,3436,3419,38963,24
94500,32927,3551,3449,39927,32
95000,32689,3582,3468,39739,32
95000,32477,3532,3482,39491,32
95000,32525,3607,3453,39585,32
95000,36399,4602,3629,44630,32
95000,34327,4005,3448,41780,32
95500,32982,3669,3522,40173,31
95500,33811,3453,3441,40705,31
95500,34126,3720,3641,41487,31
95500,31643,3543,3674,38860,31
95500,35067,3822,4087,42976,31
96000,34098,3442,3578,41118,30
96000,31887,3414,3424,38725,30
96000,35274,3620,3584,42478,25
96000,32110,3503,3538,39151,25
96000,32428,3513,3490,39431,25
96500,34790,3555,3801,42146,25
96500,33159,3493,3690,40342,25
96500,33630,3481,3959,41070,25
96500,31747,3438,3447,38632,25
96500,34172,3449,3463,41084,38
97000,32187,3426,3490,39103,38
97000,38596,4219,3543,46358,38
97000,37578,3497,3458,44533,38
97000,37290,4468,4631,46389,38
97000,32679,4264,3918,40861,38
97500,33591,3464,3482,40537,29
97500,32907,3767,3494,40168,29
97500,34169,3465,3460,41094,29
97500,33291,3480,3488,40259,29
97500,32140,4236,3461,39837,29
98000,36177,4542,4289,45008,29
98000,33643,3534,3683,40860,29
98000,34081,3564,3554,41199,29
98000,34487,3946,3637,42070,29
98000,32865,3582,3564,40011,29
98500,33069,3554,3629,40252,29
98500,33301,3569,3659,40529,29
98500,32787,3621,3566,39974,29
98500,33028,3573,3597,40198,30
98500,33422,3643,3619,40684,30
99000,33605,3583,3599,40787,30
99000,34226,3568,4017,41811,30
99000,32979,4012,3617,40608,30
99000,34082,3614,3585,41281,30
99000,34470,3548,3590,41608,30
99500,33968,3571,4239,41778,24
99500,34423,3730,3623,41776,24
99500,34329,3870,4038,42237,24
99500,33686,3606,3616,40908,24
99500,34711,3594,3643,41948,24
100000,34739,3629,3638,42006,24
100000,34654,3859,3695,42208,24
100000,33721,3622,3667,41010,26
100000,34413,3632,3701,41746,26
100000,35654,3633,4623,43910,26
100500,33870,3626,4693,42189,26
100500,34240,3691,3650,41581,26
100500,36071,3734,3698,43503,26
100500,34521,3746,3736,42003,26
100500,35312,3635,3693,42640,31
101000,34607,3641,3722,41970,31
101000,35178,3638,3677,42493,31
101000,36515,4052,3771,44338,31
101000,36475,3577,3580,43632,31
101000,36036,3565,3655,43256,31
101500,35773,3607,3832,43212,31
101500,38649,3918,3752,46319,23
101500,36126,5221,4645,45992,23
101500,36660,3772,3681,44113,23
101500,35238,3791,3852,42881,23
102000,35546,3689,3818,43053,23
102000,35441,4352,3865,43658,23
102000,37624,3705,3859,45188,23
102000,34181,3696,3684,41561,30
102000,34624,3906,3837,42367,30
102500,35056,3714,3743,42513,30
102500,36194,3805,3745,43744,30
102500,35136,4667,3711,43514,30
102500,34870,3753,3715,42338,30
102500,35228,3732,4197,43157,19
103000,35283,3918,3744,42945,19
103000,35705,3759,3853,43317,19
103000,35643,3832,3834,43309,19
103000,34834,3696,3889,42419,19
103000,34996,3767,3718,42481,19
103500,35772,3724,3767,43263,19
103500,36828,3822,3919,44569,19
103500,35354,3924,3807,43085,19
103500,35367,3727,4006,43100,24
103500,34827,4872,3792,43491,24
104000,35994,3724,3780,43498,24
104000,34818,4985,4067,43870,24
104000,35882,3808,4131,43821,24
104000,40178,4120,4047,48345,24
104000,35231,3849,3785,42865,24
104500,35422,3865,3943,43230,28
104500,37071,3955,3957,44983,28
104500,35884,3915,3788,43587,28
104500,39989,4022,3815,47826,28
104500,35531,3772,3823,43126,28
105000,41261,4059,3929,49249,28
105000,39391,3936,3820,47147,37
105000,38492,3937,3892,46321,37
105000,35781,3784,3747,43312,37
105000,35848,3694,3768,43310,37
105500,36924,4796,3809,45529,37
105500,35940,3870,3775,43585,25
105500,36344,3706,3731,43781,25
105500,35138,3739,5165,44042,25
105500,36528,3993,3865,44386,25
106000,36242,3729,3808,43779,25
106000,35540,4192,3883,43615,25
106000,38002,4437,3801,46240,25
106000,35824,3818,3850,43492,35
106000,35821,3819,3841,43481,35
106500,36321,4564,3920,44805,35
106500,38227,3817,4034,46078,35
106500,37530,3818,4160,45508,35
106500,37047,5153,4042,46242,35
106500,36842,3814,3885,44541,28
107000,52894,5312,4455,62661,28
107000,40574,4054,4356,48984,28
107000,40342,4198,3987,48527,28
107000,37266,3861,3865,44992,28
107000,38154,3883,3927,45964,28
107500,38382,4061,3860,46303,32
107500,37201,3993,4037,45231,32
107500,37633,4232,3877,45742,32
107500,37155,3845,3918,44918,32
107500,36757,3843,4588,45188,32
108000,37081,3957,4034,45072,32
108000,39156,6179,4321,49656,30
108000,36610,4377,3825,44812,30
108000,38163,4506,5886,48555,30
108000,36126,3931,4043,44100,30
108500,38680,4628,4740,48048,30
108500,39066,4607,4201,47874,30
108500,37954,4087,3927,45968,32
108500,36543,4051,3903,44497,32
108500,37144,3870,3945,44959,32
109000,39367,4274,3930,47571,32
109000,39775,3963,4042,47780,32
109000,37735,3912,4040,45687,29
109000,38196,4292,4056,46544,29
109000,39296,3898,3959,47153,29
109500,37695,4549,4101,46345,29
109500,37333,4109,4124,45566,29
109500,38092,3922,3935,45949,29
109500,37186,3923,3990,45099,29
109500,38019,3945,3982,45946,25
110000,37785,3936,4266,45987,25
110000,37923,3929,4347,46199,25
110000,38683,4268,3938,46889,25
110000,37336,4032,3958,45326,25
110000,37876,4054,4297,46227,25
110500,37497,3940,3988,45425,26
110500,37564,3983,4032,45579,26
110500,39531,4078,4143,47752,26
110500,38058,4919,3986,46963,26
110500,37483,3969,3983,45435,26
111000,38283,4045,3998,46326,26
111000,38744,3977,4198,46919,26
111000,38589,4117,3981,46687,26
111000,37670,3928,4117,45715,26
111000,40823,3986,4223,49032,26
111500,38846,4033,4075,46954,24
111500,40692,4026,3992,48710,24
111500,37985,4625,3997,46607,24
111500,39514,4069,4199,47782,31
111500,38876,3994,4179,47049,31
112000,39892,4050,4156,48098,32
112000,38430,4004,4560,46994,32
112000,38630,4057,4125,46812,32
112000,38766,4200,4017,46983,32
112000,39064,4022,4340,47426,33
112500,39678,4041,4215,47934,34
112500,39261,4087,4254,47602,34
112500,39012,4005,4438,47455,34
112500,39087,4027,4040,47154,34
112500,39211,4025,4286,47522,36
113000,55900,4387,5609,65896,36
113000,38601,4369,4106,47076,36
113000,39055,4019,4157,47231,36
113000,39892,4264,4255,48411,36
113000,40768,4181,4150,49099,29
113500,39597,6246,6053,51896,27
113500,40544,4200,4106,48850,27
113500,49487,5319,5573,60379,27
113500,44840,3992,4209,53041,27
113500,39206,3969,4052,47227,27
114000,42143,4008,4056,50207,26
114000,38470,4013,4069,46552,26
114000,42835,5020,5088,52943,26
114000,42878,4182,4605,51665,26
114000,38624,4967,5006,48597,26
114500,39825,4174,4053,48052,26
114500,45662,5120,4895,55677,32
114500,48591,4254,4035,56880,32
114500,40037,4095,4252,48384,32
114500,39467,4009,4081,47557,32
115000,40743,4266,4084,49093,32
115000,40207,4190,4218,48615,24
115000,39425,3991,4733,48149,24
115000,45849,4588,4866,55303,24
115000,42619,4677,5009,52305,24
115500,39571,4047,4096,47714,24
115500,47436,4141,4344,55921,24
115500,47912,5042,4275,57229,30
115500,41294,4502,4757,50553,30
115500,42323,4141,4379,50843,30
116000,42869,4099,4347,51315,30
116000,43133,4162,4734,52029,30
116000,58620,4351,6092,69063,30
116000,41509,4291,4188,49988,22
116000,40923,4541,4134,49598,22
116500,39596,4164,4210,47970,22
116500,40934,4310,4184,49428,22
116500,40264,4164,4179,48607,22
116500,40707,4145,5215,50067,22
116500,44098,4187,4425,52710,19
117000,40635,4574,4199,49408,19
117000,41196,5903,4875,51974,19
117000,40879,4162,4239,49280,19
117000,40247,4301,4602,49150,19
117000,40651,4225,4252,49128,19
117500,40005,4220,4227,48452,19
117500,40481,4176,4370,49027,32
117500,41565,4741,4195,50501,32
117500,41516,4355,4206,50077,32
117500,42579,4537,4384,51500,32
118000,42008,4289,4241,50538,32
118000,40900,4191,4537,49628,32
118000,44613,4274,4195,53082,28
118000,41176,4358,4287,49821,28
118000,42918,4582,4301,51801,28
118500,42230,4349,4220,50799,28
118500,40476,4246,4228,48950,28
118500,41691,4322,4226,50239,28
118500,40836,4381,4352,49569,30
118500,41005,4372,4361,49738,30
119000,43371,4305,4279,51955,30
119000,41381,4257,4636,50274,30
119000,41034,4278,4259,49571,30
119000,41706,4222,4502,50430,28
119000,42189,4400,4253,50842,28
119500,40929,4276,4255,49460,28
119500,41526,4285,4250,50061,28
119500,42919,4281,4254,51454,28
119500,42140,4295,4261,50696,28
119500,41718,4498,4250,50466,30
120000,41017,4260,4357,49634,29
120000,50291,4261,4438,58990,29
120000,41885,4276,4697,50858,29
120000,42606,4440,4526,51572,29
120000,43090,4263,4273,51626,29
120500,42413,4584,4403,51400,29
120500,43151,4277,4402,51830,29
120500,42461,4257,6281,52999,29
120500,42377,4287,4336,51000,29
120500,42100,4359,4314,50773,29
121000,43073,4303,4365,51741,23
121000,46262,4538,4306,55106,23
121000,44832,4329,4321,53482,23
121000,42786,4289,4397,51472,23
121000,41887,4537,4291,50715,23
121500,42572,4347,4501,51420,23
121500,42946,4347,4350,51643,26
121500,42129,4309,4341,50779,26
121500,42622,4494,4625,51741,26
121500,41523,4536,4538,50597,26
122000,43449,4324,4543,52316,26
122000,45719,4549,4345,54613,26
122000,43346,4325,4393,52064,24
122000,42099,4501,4318,50918,24
122000,42965,4340,4339,51644,24
122500,42969,4331,4370,51670,24
122500,43001,4430,4384,51815,24
122500,42926,4360,4404,51690,24
122500,42386,4542,4409,51337,28
122500,42801,5500,4501,52802,28
123000,42809,4527,4370,51706,28
123000,45464,4536,5201,55201,28
123000,42476,4358,4532,51366,28
123000,42945,4366,4844,52155,28
123000,43575,4373,4754,52702,30
123500,44825,4651,4465,53941,30
123500,45050,4631,4442,54123,30
123500,45943,5097,4472,55512,30
123500,44992,4380,4588,53960,30
123500,44382,4462,4510,53354,30
124000,43569,4486,4594,52649,30
124000,43225,4540,4432,52197,30
124000,46879,4651,4883,56413,30
124000,42971,4421,4400,51792,30
124000,42960,4384,4416,51760,31
124500,44188,4493,4523,53204,31
124500,42794,4475,4417,51686,31
124500,42546,4388,4566,51500,31
124500,42588,4427,4390,51405,31
124500,44997,4718,4535,54250,31
125000,43571,4437,4453,52461,26
125000,43041,4344,4367,51752,26
125000,47534,4519,4457,56510,26
125000,44558,4432,4435,53425,26
125000,43588,5097,5355,54040,26
125500,43725,4430,4461,52616,31
125500,44373,4444,4573,53390,31
125500,43631,4441,4940,53012,31
125500,44321,4790,4660,53771,31
125500,43240,4400,4845,52485,31
126000,44222,4842,4554,53618,31
126000,43748,4987,4471,53206,31
126000,42903,4435,4479,51817,31
126000,44901,4539,4594,54034,31
126000,43012,4468,4459,51939,31
126500,45375,4494,4494,54363,31
126500,43836,4540,4487,52863,28
126500,43061,4485,5053,52599,28
126500,54186,4559,4518,63263,28
126500,45254,4505,4498,54257,28
127000,52766,4535,4882,62183,28
127000,44810,4469,4537,53816,26
127000,47328,7643,6887,61858,26
127000,44449,6460,7178,58087,26
127000,54256,4583,4539,63378,26
127500,44009,5145,4639,53793,26
127500,45243,4588,4517,54348,29
127500,44725,4528,4515,53768,29
127500,46243,4527,4525,55295,29
127500,44684,5029,4510,54223,29
128000,44088,4512,4594,53194,29
128000,43829,4504,4637,52970,22
128000,44331,4506,4572,53409,22
128000,51996,5620,4531,62147,22
128000,44381,4589,4821,53791,22
128500,45334,4632,5870,55836,22
128500,46313,4520,5023,55856,22
128500,44453,4523,4631,53607,26
128500,45352,4519,4568,54439,26
128500,45405,4568,4649,54622,26
129000,48176,4754,4826,57756,27
129000,45273,4897,4622,54792,27
129000,45937,4521,4600,55058,27
129000,44733,4705,4730,54168,28
129000,45160,4571,4595,54326,28
129500,44918,4546,4608,54072,28
129500,44500,4581,4572,53653,28
129500,45035,4603,4606,54244,28
129500,45213,4838,4699,54750,28
129500,46446,4616,4631,55693,28
130000,45427,4610,4604,54641,28
130000,45858,4627,4585,55070,28
130000,49976,4618,4666,59260,28
130000,45632,4571,5649,55852,28
130000,45659,4633,4854,55146,28
130500,46114,4808,4596,55518,28
130500,50519,4612,4607,59738,28
130500,46405,4637,4602,55644,28
130500,47585,4873,4912,57370,28
130500,45989,4584,4641,55214,24
131000,48768,4600,5195,58563,24
131000,45550,4751,4697,54998,24
131000,46014,4779,4675,55468,24
131000,51378,4516,4588,60482,24
131000,48694,4685,4618,57997,32
131500,45598,4667,4634,54899,32
131500,49271,4564,4579,58414,32
131500,44699,4553,4672,53924,32
131500,49074,5570,4941,59585,32
131500,46063,4673,4622,55358,30
132000,45512,4652,4676,54840,30
132000,50031,4765,5087,59883,30
132000,45825,4608,4599,55032,30
132000,46556,6052,5693,58301,30
132000,55566,4624,5255,65445,32
132500,46227,5116,5577,56920,32
132500,45928,4626,4631,55185,32
132500,66913,5715,5667,78295,32
132500,46289,4602,4669,55560,26
132500,45804,4765,4955,55524,26
133000,47290,5003,4821,57114,26
133000,46445,4716,4910,56071,26
133000,46659,5269,4730,56658,26
133000,46714,4675,4700,56089,26
133000,50669,4712,4709,60090,29
133500,46382,4796,4722,55900,29
133500,46543,4719,4873,56135,29
133500,46676,4716,4696,56088,29
133500,46844,4865,4971,56680,29
133500,45874,4688,4759,55321,35
134000,46479,5080,4761,56320,35
134000,45857,4684,4675,55216,35
134000,46371,4709,4645,55725,35
134000,45655,4803,4672,55130,20
134000,44974,4612,4657,54243,20
134500,45611,4844,4867,55322,20
134500,48436,5226,4999,58661,20
134500,45889,4653,4683,55225,20
134500,46043,4864,4660,55567,20
134500,47608,4733,4750,57091,20
135000,47612,4768,4968,57348,35
135000,47662,4743,4813,57218,35
135000,47323,4751,4869,56943,35
135000,46901,4751,5170,56822,35
135000,47251,4746,4835,56832,25
135500,47015,4791,5618,57424,25
135500,47942,4774,4791,57507,25
135500,48038,5181,6059,59278,25
135500,48772,4904,4909,58585,25
135500,47113,5118,4901,57132,25
136000,48331,4842,4905,58078,27
136000,48160,4777,4793,57730,27
136000,48195,5267,4818,58280,27
136000,47748,4809,4822,57379,27
136000,48031,4791,4805,57627,27
136500,47877,4808,4817,57502,29
136500,48223,4793,5415,58431,29
136500,47630,4800,4926,57356,29
136500,47570,4776,4825,57171,29
136500,48401,4768,5007,58176,29
137000,47776,4876,5009,57661,24
137000,47990,4808,4895,57693,24
137000,49141,4927,4839,58907,24
137000,48322,4799,4851,57972,24
137000,47603,4801,4849,57253,24
137500,48126,4812,5116,58054,24
137500,49142,5028,5068,59238,21
137500,47651,4833,4861,57345,21
137500,48689,4839,4962,58490,21
137500,47858,4808,4870,57536,21
138000,48303,4854,4862,58019,21
138000,48360,4863,4874,58097,26
138000,48399,4874,4917,58190,26
138000,49089,4894,4858,58841,26
138000,50174,4874,4938,59986,26
138500,49524,4750,4860,59134,26
138500,50391,4855,4849,60095,26
138500,50483,6617,5408,62508,26
138500,49014,4983,5154,59151,26
138500,48738,5428,5088,59254,26
139000,49508,5022,4977,59507,26
139000,49345,5069,4947,59361,26
139000,49442,4928,4884,59254,32
139000,49652,4984,4933,59569,32
139000,49423,4945,5043,59411,32
139500,53032,4957,5307,63296,32
139500,50286,4907,5181,60374,26
139500,50916,4964,4907,60787,26
139500,54360,4919,4871,64150,26
139500,50891,5327,4995,61213,26
140000,52579,4947,5477,63003,26
140000,51488,6642,5024,63154,26
140000,58780,4904,4912,68596,26
140000,49478,4950,4944,59372,26
140000,52309,5461,5472,63242,26
140500,50841,4897,4892,60630,26
140500,47443,4838,4869,57150,30
140500,50615,6034,5877,62526,30
140500,54561,5208,5302,65071,30
140500,48682,5028,5553,59263,30
141000,54974,5323,5736,66033,21
141000,49425,4923,4880,59228,21
141000,48209,4858,5128,58195,21
141000,48604,4856,4905,58365,21
141000,48747,5002,4889,58638,21
141500,51925,4960,5241,62126,21
141500,49098,5319,4945,59362,29
141500,49246,4931,4982,59159,29
141500,49928,4954,4984,59866,29
141500,50034,4936,4990,59960,29
142000,50434,4948,5005,60387,29
142000,49915,5008,5052,59975,27
142000,55552,7664,7725,70941,27
142000,49370,4960,4995,59325,27
142000,51890,4978,5004,61872,27
142500,50545,4981,6014,61540,27
142500,49805,4962,5038,59805,28
142500,50295,5116,5193,60604,28
142500,51006,5063,5177,61246,28
142500,53318,5113,5017,63448,28
143000,50031,4974,5286,60291,21
143000,51292,4977,5069,61338,21
143000,50353,4974,5056,60383,21
143000,49169,5188,5035,59392,21
143000,50225,4961,5048,60234,21
143500,50822,5023,5198,61043,21
143500,51129,5017,5562,61708,28
143500,50273,5001,5811,61085,28
143500,50152,4999,5088,60239,28
143500,50189,4998,5058,60245,28
144000,51020,5235,5265,61520,28
144000,51685,5227,5277,62189,28
144000,60481,7573,5400,73454,28
144000,50613,5097,5037,60747,28
144000,50920,5034,5106,61060,28
144500,50098,5026,5284,60408,28
144500,50642,5318,5069,61029,33
144500,50313,5483,5229,61025,33
144500,50713,5100,5022,60835,33
144500,51689,5173,5060,61922,33
145000,73080,5783,5360,84223,22
145000,51624,5217,5077,61918,22
145000,50924,5076,5094,61094,22
145000,51806,5302,5040,62148,22
145000,50849,5040,5100,60989,22
145500,51879,5064,5310,62253,22
145500,53617,5178,5361,64156,26
145500,52920,5170,5265,63355,26
145500,52499,5079,5108,62686,26
145500,52026,5102,5115,62243,26
146000,51601,5118,5223,61942,26
146000,53874,5200,5984,65058,31
146000,52206,5091,5116,62413,31
146000,51159,5249,5821,62229,31
146000,52037,5097,5128,62262,31
146500,52031,5480,7583,65094,34
146500,63855,6383,6429,76667,34
146500,65462,6300,6280,78042,34
146500,61576,6658,6392,74626,34
146500,57210,5335,6165,68710,31
147000,53241,6585,5826,65652,31
147000,53842,5247,5179,64268,31
147000,54207,5113,5156,64476,31
147000,52445,5617,5292,63354,33
147000,52934,5515,5467,63916,33
147500,59298,5153,5216,69667,33
147500,52500,5353,5622,63475,33
147500,52083,5175,5152,62410,32
147500,51950,5132,5146,62228,32
147500,54415,5188,5322,64925,32
148000,53366,5163,5187,63716,32
148000,52045,6118,5238,63401,32
148000,51587,5263,5371,62221,26
148000,52354,5125,5309,62788,26
148000,51422,5136,5207,61765,26
148500,71264,5150,5272,81686,26
148500,52595,5709,5201,63505,30
148500,52397,5184,5175,62756,30
148500,53242,5354,5199,63795,30
148500,53171,5176,5305,63652,30
149000,54051,5189,5416,64656,30
149000,52821,5188,5210,63219,21
149000,53012,5220,5730,63962,21
149000,52628,5183,5204,63015,21
149000,53335,5188,5214,63737,21
149500,53341,5397,5192,63930,21
149500,54067,5215,5478,64760,30
149500,52588,5247,5222,63057,30
149500,52719,5216,5263,63198,30
149500,53668,5216,5205,64089,30
150000,52852,5995,5263,64110,30
150000,53378,5196,5541,64115,26
150000,52608,5517,5441,63566,26
150000,53103,5339,5239,63681,26
150000,55932,5593,5257,66782,26
150500,53593,5275,5314,64182,26
150500,53918,5406,5633,64957,26
150500,53916,5372,5479,64767,26
150500,53505,5234,5318,64057,26
150500,54601,5355,5246,65202,26
151000,53438,5345,5277,64060,23
151000,53505,5213,5572,64290,23
151000,53875,5885,5361,65121,23
151000,53109,5780,5431,64320,23
151000,54289,5275,5260,64824,23
151500,54033,5402,5317,64752,30
151500,54728,5615,5375,65718,30
151500,53902,5230,5304,64436,30
151500,53418,5279,5282,63979,30
151500,56385,5454,5270,67109,30
152000,55413,5240,5313,65966,33
152000,54388,5360,5307,65055,33
152000,57199,5418,5260,67877,33
152000,55692,5316,5574,66582,33
152000,53283,5800,5239,64322,27
152500,52893,5468,6660,65021,27
152500,52174,5393,5287,62854,27
152500,58679,5354,5297,69330,27
152500,55949,5836,5355,67140,30
152500,53822,5288,5318,64428,30
153000,54436,5282,5693,65411,30
153000,54983,5534,5600,66117,30
153000,53648,5283,5363,64294,30
153000,55387,5442,5425,66254,27
153000,53212,5285,5834,64331,27
153500,62992,5454,6124,74570,27
153500,55618,5817,5356,66791,27
153500,55105,5297,5330,65732,25
153500,54479,5430,5350,65259,25
153500,53898,5285,5408,64591,25
154000,54718,5310,5375,65403,25
154000,53944,5337,5353,64634,25
154000,55050,5441,5471,65962,32
154000,54498,5459,5410,65367,32
154000,53975,5329,5370,64674,32
154500,54347,5424,5517,65288,32
154500,66880,6032,5666,78578,24
154500,55308,6076,5772,67156,24
154500,59104,5423,5591,70118,24
154500,55432,5335,5969,66736,24
155000,59508,5834,5397,70739,24
155000,56944,5370,5414,67728,28
155000,56452,5577,5900,67929,28
155000,55139,5411,5413,65963,28
155000,57058,5504,5878,68440,28
155500,57118,6035,5451,68604,28
155500,56547,5794,5422,67763,23
155500,57747,5703,5555,69005,23
155500,57314,5646,5848,68808,23
155500,56169,5402,5447,67018,23
156000,55843,5497,5547,66887,24
156000,55928,5443,5433,66804,24
156000,57625,5479,5612,68716,24
156000,58912,5710,5451,70073,24
156000,56328,5549,5453,67330,24
156500,108065,8204,5540,121809,30
156500,63812,6337,6150,76299,30
156500,60344,5557,5461,71362,30
156500,58193,5689,5812,69694,30
156500,56520,5521,5462,67503,32
157000,56554,5420,5603,67577,32
157000,58606,5717,5760,70083,32
157000,58201,5443,5591,69235,32
157000,57873,5591,5494,68958,33
157000,78187,9604,10636,98427,33
157500,59397,5596,5897,70890,33
157500,63016,5467,5449,73932,33
157500,55098,7159,5776,68033,30
157500,56498,5350,5415,67263,30
157500,77583,5408,6147,89138,30
158000,55069,5598,5677,66344,30
158000,55596,6114,6055,67765,26
158000,55771,5453,5480,66704,26
158000,56065,6150,5593,67808,26
158000,56067,5391,5656,67114,26
158500,61161,5815,5492,72468,25
158500,57218,5527,6107,68852,25
158500,56417,5466,5490,67373,25
158500,56137,5467,5512,67116,25
158500,55645,5514,5497,66656,25
159000,65196,6876,6012,78084,25
159000,59573,5489,5513,70575,25
159000,57093,5478,5628,68199,25
159000,57125,5738,5550,68413,25
159000,56677,5590,5563,67830,31
159500,60432,5512,5541,71485,31
159500,55965,5494,5510,66969,31
159500,55904,5502,5900,67306,31
159500,56481,5578,5547,67606,30
159500,56405,5819,5678,67902,30
160000,56623,5887,5540,68050,30
160000,56087,5539,5587,67213,30
160000,57598,6557,5705,69860,30
160000,58573,5510,7228,71311,30
160000,64549,6836,6885,78270,30
160500,57275,5542,5508,68325,30
160500,69074,6879,6842,82795,27
160500,64293,5966,5774,76033,27
160500,67392,6120,5517,79029,27
160500,58614,5533,5516,69663,27
161000,72103,5592,7298,84993,27
161000,57096,5544,5604,68244,28
161000,58244,5574,5715,69533,28
161000,58214,5549,5590,69353,28
161000,57369,5587,5631,68587,28
161500,58971,5738,5631,70340,26
161500,57092,5766,5733,68591,26
161500,61443,5648,5814,72905,26
161500,57151,5505,5513,68169,26
161500,57360,5590,5666,68616,31
162000,56931,5875,5930,68736,31
162000,56415,5559,5625,67599,31
162000,58871,5624,5610,70105,31
162000,57612,6154,5601,69367,27
162000,57453,5598,5799,68850,27
162500,65250,5757,5672,76679,27
162500,57189,5741,5765,68695,27
162500,57858,5596,5639,69093,33
162500,57466,6374,5872,69712,33
162500,58226,5862,5663,69751,33
163000,59642,5672,5780,71094,33
163000,57593,5670,6193,69456,28
163000,58150,5603,5639,69392,28
163000,59076,5833,5757,70666,28
163000,57848,5590,5684,69122,28
163500,74219,5722,6152,86093,22
163500,74418,6127,5711,86256,22
163500,59289,5931,6066,71286,22
163500,58921,5651,5680,70252,22
163500,59623,6062,5715,71400,22
164000,84425,6132,6033,96590,25
164000,58529,5692,5748,69969,25
164000,58411,5538,7414,71363,25
164000,66722,5733,5659,78114,25
164000,57216,5563,5613,68392,25
164500,59186,5768,5637,70591,25
164500,57322,5585,5659,68566,25
164500,60504,5583,5622,71709,25
164500,59101,5773,5721,70595,25
164500,58198,5681,5674,69553,26
165000,58370,5835,5876,70081,26
165000,63741,5670,5702,75113,26
165000,59520,5676,5887,71083,26
165000,57754,5680,5721,69155,35
165000,58427,5673,5701,69801,35
165500,59347,5750,5695,70792,35
165500,58457,6132,5715,70304,35
165500,58554,5764,5813,70131,29
165500,57858,5741,5696,69295,29
165500,59436,13313,8597,81346,29
166000,59053,5917,5900,70870,29
166000,58674,5700,5733,70107,27
166000,59047,5693,5758,70498,27
166000,59152,5763,5711,70626,27
166000,59586,5781,6676,72043,27
166500,59007,5712,5737,70456,29
166500,58388,5721,6090,70199,29
166500,58785,5732,5753,70270,29
166500,58673,5715,5768,70156,29
166500,58892,5935,5799,70626,32
167000,59971,6971,5783,72725,32
167000,58958,5733,5775,70466,32
167000,60331,5742,5757,71830,32
167000,59250,5731,5801,70782,31
167000,73846,5837,5824,85507,31
167500,60693,5754,5790,72237,31
167500,60753,5839,5827,72419,31
167500,60195,6042,5815,72052,24
167500,59695,5780,5806,71281,24
167500,78944,5856,5827,90627,24
168000,60158,5784,5795,71737,24
168000,59641,5947,5771,71359,24
168000,60987,5882,5808,72677,27
168000,59374,5757,5814,70945,27
168000,60035,5775,6136,71946,27
168500,64687,5781,5788,76256,27
168500,60087,5809,5816,71712,36
168500,60300,5865,5839,72004,36
168500,59125,5693,5750,70568,36
168500,59444,5799,5851,71094,36
169000,79460,6822,6233,92515,27
169000,58954,5716,5735,70405,27
169000,60203,5784,6411,72398,27
169000,59786,5793,5821,71400,19
169000,60036,5843,5840,71719,19
169500,72122,6358,6651,85131,19
169500,60294,5796,5862,71952,19
169500,60170,5802,6102,72074,19
169500,60674,5853,5885,72412,19
169500,59924,6074,5840,71838,28
170000,61092,6047,5898,73037,28
170000,61009,5867,5856,72732,28
170000,60825,6238,5876,72939,28
170000,60401,5863,5861,72125,32
170000,60614,6144,5898,72656,32
170500,77142,5851,5883,88876,32
170500,61536,5866,5947,73349,32
170500,60528,6402,5910,72840,28
170500,63484,6074,6039,75597,28
170500,60787,5857,5924,72568,28
171000,61561,5863,5887,73311,28
171000,60146,6092,5878,72116,26
171000,60593,5836,6463,72892,26
171000,61377,5862,5884,73123,26
171000,60576,5871,5921,72368,26
171500,62858,6526,5992,75376,26
171500,61345,5883,6208,73436,26
171500,65896,5926,5909,77731,26
171500,62899,5859,5908,74666,26
171500,61288,5922,5900,73110,30
172000,61364,6780,5912,74056,30
172000,61328,5981,6783,74092,30
172000,61287,5877,5955,73119,30
172000,60745,6000,5916,72661,30
172000,74158,6026,6251,86435,30
172500,63880,6430,6004,76314,30
172500,61797,6019,5960,73776,30
172500,61135,5908,5959,73002,29
172500,61307,5905,6442,73654,29
172500,61286,5926,5957,73169,29
173000,62020,5942,5996,73958,29
173000,61614,5931,5980,73525,28
173000,62144,5936,5979,74059,28
173000,65067,5998,5975,77040,28
173000,62723,7021,6010,75754,28
173500,72798,7316,7607,87721,30
173500,60967,5823,6000,72790,30
173500,60585,5875,5915,72375,30
173500,64680,6239,6820,77739,30
173500,73898,5915,5981,85794,26
174000,61429,5924,6682,74035,26
174000,61944,5944,5978,73866,26
174000,63679,5955,6176,75810,26
174000,61446,5927,6014,73387,29
174000,61211,5941,5980,73132,29
174500,62610,6006,6094,74710,29
174500,62440,5970,6038,74448,29
174500,62652,6005,6037,74694,33
174500,62770,5976,6080,74826,33
174500,62743,6186,6195,75124,33
175000,66670,6361,6339,79370,27
175000,61922,6112,5999,74033,27
175000,62146,5982,6049,74177,27
175000,62066,6045,6036,74147,27
175000,62636,6000,6022,74658,28
175500,61781,6002,6035,73818,28
175500,65060,6115,6111,77286,28
175500,63118,6035,6019,75172,28
175500,63122,5994,6054,75170,27
175500,73952,6301,6073,86326,27
176000,64489,6005,6075,76569,27
176000,64559,6038,6057,76654,27
176000,63037,5988,6059,75084,33
176000,62039,6023,6415,74477,33
176000,71804,6024,6346,84174,33
176500,63198,6022,6228,75448,33
176500,63237,6182,6105,75524,29
176500,62095,6031,6058,74184,29
176500,62638,6165,6308,75111,29
176500,79094,6062,6177,91333,29
177000,65124,6466,6098,77688,24
177000,63238,6235,6115,75588,24
177000,63469,6893,6132,76494,24
177000,62841,6218,6072,75131,24
177000,63204,6280,6081,75565,34
177500,67051,6099,6095,79245,34
177500,65031,6071,6220,77322,34
177500,66284,6055,6093,78432,27
177500,63886,6310,6116,76312,27
177500,68836,6072,6103,81011,27
178000,63780,6076,6114,75970,27
178000,63523,6063,6181,75767,31
178000,63859,6128,6546,76533,31
178000,69834,7132,6677,83643,31
178000,63681,6156,7994,77831,31
178500,64323,6565,6220,77108,31
178500,64037,6115,6163,76315,31
178500,65358,6125,6136,77619,31
178500,63418,6094,6146,75658,31
178500,64199,6088,6432,76719,31
179000,63941,6098,6153,76192,31
179000,64471,6248,6144,76863,31
179000,63321,6101,6155,75577,35
179000,63643,6117,6166,75926,35
179000,63307,6464,6347,76118,35
179500,63945,6124,6214,76283,35
179500,63624,6120,6588,76332,29
179500,82359,7295,6965,96619,29
179500,65025,6280,6206,77511,29
179500,77189,6193,6190,89572,29
180000,64451,6134,6205,76790,24
180000,63779,6433,6220,76432,24
180000,64401,6162,6179,76742,24
180000,64276,6128,6184,76588,24
180000,64270,6778,6188,77236,29
180500,64680,6364,6240,77284,29
180500,65973,6144,6193,78310,29
180500,64325,6318,6181,76824,29
180500,66604,6446,6241,79291,25
180500,88728,8605,6409,103742,25
181000,66021,6468,6828,79317,25
181000,64492,6479,6305,77276,30
181000,64715,6151,6236,77102,30
181000,65221,6332,6212,77765,30
181000,64267,6309,6506,77082,30
181500,64325,6213,6241,76779,26
181500,64997,6170,6229,77396,26
181500,64049,6372,6210,76631,26
181500,64857,6191,6279,77327,26
181500,65181,6183,6253,77617,25
182000,66073,6456,6468,78997,25
182000,64168,6229,6285,76682,25
182000,64660,7539,6729,78928,25
182000,70048,6457,6437,82942,33
182000,81777,6207,6213,94197,33
182500,65246,6239,6243,77728,33
182500,65072,6179,6284,77535,26
182500,65479,6235,6462,78176,26
182500,65354,6340,6364,78058,26
182500,67830,6534,6491,80855,26
183000,69468,6329,6515,82312,26
183000,70629,6916,6495,84040,26
183000,68155,6302,6377,80834,26
183000,67497,6241,6298,80036,26
183000,82671,6769,7297,96737,24
183500,67546,6644,7231,81421,24
183500,66831,6292,6567,79690,24
183500,66535,6459,6287,79281,24
183500,67491,6276,6281,80048,23
183500,65221,6245,6286,77752,23
184000,66998,6305,6489,79792,23
184000,65932,6261,6297,78490,23
184000,66163,6252,6290,78705,23
184000,66939,6268,6327,79534,27
184000,65730,6264,6569,78563,27
184500,66519,6267,6325,79111,27
184500,65752,6618,6347,78717,27
184500,65903,6289,6294,78486,29
184500,67256,6689,6869,80814,29
184500,128484,7861,6336,142681,29
185000,66693,6285,6389,79367,27
185000,66909,6956,6471,80336,27
185000,67216,6310,6328,79854,27
185000,67483,6305,6430,80218,27
185000,93495,6208,6241,105944,29
185500,65207,6260,6300,77767,29
185500,69352,6345,6602,82299,29
185500,64298,6486,6347,77131,29
185500,66757,6200,6291,79248,32
185500,68179,6208,6260,80647,32
186000,65760,6251,6897,78908,32
186000,66602,6632,6278,79512,32
186000,68567,6600,6511,81678,32
186000,66638,6547,6432,79617,32
186000,72417,6635,6322,85374,32
186500,72051,6258,6296,84605,26
186500,65793,6856,6397,79046,26
186500,68862,6236,6304,81402,26
186500,67663,6612,6896,81171,38
186500,66792,7022,6340,80154,38
187000,82650,7882,8427,98959,38
187000,76438,7676,6384,90498,24
187000,68901,6412,6580,81893,24
187000,66914,6456,6619,79989,24
187000,90582,8098,8577,107257,24
187500,74155,8643,8484,91282,30
187500,66805,6322,7658,80785,30
187500,67625,6359,6637,80621,30
187500,70409,6572,6404,83385,29
187500,67099,6365,6554,80018,29
188000,66670,6382,6448,79500,29
188000,69367,6366,6467,82200,29
188000,68369,6501,6479,81349,27
188000,67234,6406,6418,80058,27
188000,67747,6370,6421,80538,27
188500,69254,6485,7164,82903,27
188500,69833,6609,6526,82968,24
188500,67211,6412,6434,80057,24
188500,67208,6439,6451,80098,24
188500,73341,7157,18851,99349,24
189000,66925,6330,6401,79656,26
189000,66335,6311,6400,79046,26
189000,69861,6421,6665,82947,26
189000,66215,6374,6390,78979,26
189000,68053,6847,6375,81275,25
189500,67233,6617,6382,80232,25
189500,67392,7348,6511,81251,25
189500,67644,6520,6404,80568,25
189500,66651,6348,6403,79402,25
189500,69300,6349,6737,82386,25
190000,67861,6474,6557,80892,25
190000,71920,6546,6791,85257,25
190000,67591,6474,6517,80582,24
190000,67800,6462,6445,80707,24
190000,68674,6451,6904,82029,24
190500,68284,6450,6549,81283,24
190500,67991,6534,6555,81080,30
190500,67800,6917,6495,81212,30
190500,67992,6853,6500,81345,30
190500,68068,6481,6505,81054,23
191000,80870,6535,6519,93924,23
191000,72346,6500,6967,85813,23
191000,69011,6494,6508,82013,23
191000,78968,9204,8593,96765,30
191000,69244,6447,6503,82194,30
191500,69344,6499,6754,82597,30
191500,69508,6711,6531,82750,30
191500,68585,6490,6558,81633,35
191500,68124,6534,7848,82506,35
191500,69152,6849,6524,82525,35
192000,70496,7052,6559,84107,30
192000,70213,7070,6565,83848,30
192000,69558,6510,7003,83071,30
192000,68608,6522,6871,82001,29
192000,68884,6534,6527,81945,29
192500,69254,6531,6568,82353,29
192500,69502,6513,6563,82578,29
192500,70407,6531,6602,83540,28
192500,68835,6543,6570,81948,28
192500,81984,6525,7292,95801,28
193000,69571,6595,6605,82771,28
193000,69894,6586,6601,83081,33
193000,70322,6534,6594,83450,33
193000,73320,6667,6622,86609,33
193000,70038,6526,6596,83160,25
193500,68855,6896,6712,82463,25
193500,68547,6568,6593,81708,25
193500,70226,6557,6609,83392,25
193500,68535,6543,6596,81674,27
193500,78009,7445,9507,94961,27
194000,69444,6901,6652,82997,27
194000,70743,6744,6840,84327,27
194000,68649,6646,6732,82027,30
194000,69224,6471,6543,82238,30
194000,72154,7408,7147,86709,30
194500,79651,6531,6526,92708,32
194500,70910,6600,6896,84406,32
194500,69891,6664,6987,83542,32
194500,69786,6787,6637,83210,27
194500,69470,6808,6616,82894,27
195000,70369,6602,6748,83719,27
195000,69799,6650,6650,83099,27
195000,69709,6645,6641,82995,28
195000,69752,6638,6767,83157,28
195000,73905,6672,6658,87235,28
195500,74349,7201,6662,88212,28
195500,70472,6856,7004,84332,28
195500,70090,6618,6665,83373,28
195500,69876,6702,6951,83529,28
195500,69621,6505,6587,82713,27
196000,70953,6648,6635,84236,27
196000,70846,6771,6676,84293,27
196000,69838,6919,6742,83499,27
196000,71277,6651,6642,84570,24
196000,89515,6760,6983,103258,24
196500,69812,6641,6730,83183,24
196500,79907,8267,6872,95046,24
196500,70054,6616,6611,83281,27
196500,86695,8123,8397,103215,27
196500,69381,6560,7574,83515,27
197000,69598,6588,6596,82782,35
197000,75136,8354,8307,91797,35
197000,72336,6660,6696,85692,35
197000,70462,6784,6731,83977,25
197000,70279,7165,6729,84173,25
197500,71209,6674,7056,84939,25
197500,72529,6688,6736,85953,25
197500,72429,6705,6775,85909,26
197500,71880,6692,6757,85329,26
197500,86636,6699,7031,100366,26
198000,71048,6724,7161,84933,24
198000,70921,6701,6744,84366,24
198000,70392,6694,7591,84677,24
198000,71528,6854,6867,85249,24
198000,84422,7452,8585,100459,25
198500,80741,7803,9835,98379,24
198500,71050,6845,7098,84993,24
198500,72619,6770,7120,86509,24
198500,71522,6699,6771,84992,30
198500,71919,6722,6746,85387,30
199000,71805,6734,6905,85444,30
199000,71532,6825,6913,85270,30
199000,71035,6734,6807,84576,22
199000,71567,6761,6770,85098,22
199000,87410,6843,7031,101284,22
199500,71574,7304,6910,85788,27
199500,71396,6792,6840,85028,27
199500,71072,6839,6812,84723,27
199500,71394,6754,6855,85003,27
199500,80988,6789,6777,94554,29
200000,71903,7218,6853,85974,29
200000,71503,6748,6812,85063,29
200000,73852,6855,6900,87607,29
200000,71202,6720,6790,84712,34
200000,71993,6753,6804,85550,34
200500,72195,7053,6806,86054,32
200500,72445,6770,6826,86041,30
200500,73126,6764,6801,86691,30
200500,72766,6790,6807,86363,30
200500,74554,7130,6877,88561,30
201000,72297,6795,6890,85982,30
201000,72023,7022,6823,85868,30
201000,72659,6898,6882,86439,20
201000,72786,6834,6856,86476,20
201000,78002,10149,7273,95424,20
201500,73454,6834,6879,87167,20
201500,73819,6812,6852,87483,20
201500,72900,6833,7208,86941,21
201500,72745,6812,6866,86423,21
201500,72837,7083,6868,86788,21
202000,80768,8321,7061,96150,22
202000,73900,6962,7342,88204,27
202000,73126,6813,6838,86777,27
202000,71690,6905,6878,85473,27
202000,81743,6836,6864,95443,30
202500,75475,7084,6939,89498,30
202500,72647,7209,6998,86854,30
202500,72196,6849,6873,85918,30
202500,74280,6845,6870,87995,30
202500,72501,6834,6911,86246,30
203000,75631,7209,6911,89751,30
203000,74028,6848,6899,87775,30
203000,78540,7943,7137,93620,30
203000,73279,6844,6893,87016,30
203000,72552,6858,7029,86439,28
203500,72991,7048,6906,86945,28
203500,76195,7134,7007,90336,28
203500,73528,6873,6941,87342,28
203500,73837,7116,6902,87855,27
203500,73447,7140,6918,87505,27
204000,73768,6898,6912,87578,27
204000,73028,6898,6946,86872,27
204000,73552,6953,7089,87594,27
204000,73205,6870,7004,87079,27
204000,74028,6873,6949,87850,27
204500,73386,6920,7060,87366,30
204500,74500,6933,6914,88347,30
204500,74058,6910,8162,89130,30
204500,73668,6811,6870,87349,27
204500,72678,6799,6850,86327,27
205000,74045,7107,6951,88103,27
205000,74575,7332,6996,88903,27
205000,73413,6917,6970,87300,24
205000,73266,6964,6954,87184,24
205000,93217,7083,7194,107494,24
205500,75729,6939,6984,89652,26
205500,79074,6949,6977,93000,26
205500,75146,7003,7031,89180,26
205500,74950,6917,6978,88845,26
205500,74307,6927,6952,88186,31
206000,73700,6834,7067,87601,31
206000,76298,6864,6903,90065,31
206000,74373,6805,6902,88080,22
206000,75333,7311,7191,89835,22
206000,73513,7035,7018,87566,22
206500,78699,7034,7162,92895,22
206500,74973,7401,7004,89378,27
206500,74789,6953,7444,89186,27
206500,74688,7349,7437,89474,27
206500,74882,7098,7175,89155,31
207000,75614,7115,7110,89839,31
207000,75203,6989,7430,89622,31
207000,75281,6973,7024,89278,31
207000,74874,7203,7918,89995,27
207000,74383,7011,7015,88409,27
207500,75804,7031,7101,89936,27
207500,78589,7018,7065,92672,27
207500,75164,6978,7140,89282,27
207500,80794,7108,6893,94795,27
207500,76842,6918,6961,90721,30
208000,80725,7106,7085,94916,30
208000,75086,7005,7046,89137,30
208000,74475,7010,7079,88564,27
208000,75221,7117,7424,89762,27
208000,74822,7025,7075,88922,27
208500,75255,7060,7061,89376,26
208500,74848,7024,7061,88933,27
208500,74647,7009,7062,88718,27
208500,74495,7017,7055,88567,27
208500,75139,7020,7070,89229,29
209000,76268,7129,7083,90480,29
209000,76051,7260,7083,90394,29
209000,75905,7173,7098,90176,29
209000,75617,7446,7233,90296,30
209000,75666,7043,7094,89803,30
209500,75857,7095,7134,90086,30
209500,75017,7313,7079,89409,22
209500,75216,7059,7190,89465,22
209500,75394,7091,7105,89590,22
209500,91810,7072,7127,106009,22
210000,76374,7120,7241,90735,29
210000,75795,7082,7117,89994,29
210000,76239,7155,7275,90669,29
210000,75704,7179,7118,90001,32
210000,75847,7067,7277,90191,32
210500,76264,7075,7175,90514,32
210500,77009,7258,7237,91504,28
210500,77131,7072,7149,91352,28
210500,75281,7273,7141,89695,28
210500,75705,7182,7157,90044,36
211000,79495,7121,7610,94226,36
211000,76715,7465,7843,92023,36
211000,76420,7100,7165,90685,24
211000,79689,7153,7152,93994,24
211000,75891,7114,7159,90164,24
211500,77201,7147,7154,91502,24
211500,77231,7117,7161,91509,26
211500,75766,7128,7158,90052,26
211500,75771,7114,7482,90367,26
211500,76657,7106,7173,90936,34
212000,76697,7230,7202,91129,34
212000,76860,7118,7181,91159,34
212000,76498,7048,7101,90647,30
212000,81629,7251,7174,96054,30
212000,74903,7069,7088,89060,30
212500,83028,7906,7520,98454,27
212500,77730,7069,7105,91904,27
212500,77673,7318,7176,92167,27
212500,77705,7145,7217,92067,27
212500,83286,7283,7362,97931,34
213000,77558,7950,7657,93165,34
213000,76624,7266,7185,91075,34
213000,80340,7144,7202,94686,26
213000,77133,7181,7217,91531,26
213000,77729,7205,7212,92146,26
213500,77075,7197,7219,91491,25
213500,77287,7666,7322,92275,25
213500,77448,7285,8563,93296,25
213500,76693,7212,7219,91124,27
213500,78375,7444,7231,93050,27
214000,77138,7180,7282,91600,27
214000,77573,7185,7224,91982,27
214000,79576,7550,7529,94655,27
214000,79281,7235,7358,93874,27
214000,80052,7271,7235,94558,27
214500,77882,7346,7254,92482,36
214500,81177,7233,7315,95725,36
214500,78957,7273,7282,93512,36
214500,78212,7439,7454,93105,29
214500,80842,7223,7266,95331,29
215000,79645,7553,7283,94481,29
215000,78258,7441,7429,93128,25
215000,76221,7132,7191,90544,25
215000,76975,7129,7223,91327,25
215000,78502,7628,7223,93353,19
215500,77210,7191,7378,91779,19
215500,78557,11890,14059,104506,19
215500,77146,7211,7217,91574,19
215500,81678,7385,7609,96672,26
215500,89817,7274,7283,104374,26
216000,80972,7433,7728,96133,26
216000,83847,7649,7785,99281,26
216000,81794,7786,7436,97016,31
216000,82176,7575,26276,116027,31
216000,80348,8221,8152,96721,31
216500,86801,7291,7712,101804,23
216500,83098,7578,7309,97985,23
216500,79835,7474,7444,94753,23
216500,84714,8957,8060,101731,28
216500,77973,7187,7404,92564,28
217000,81382,7500,7428,96310,28
217000,79391,7521,7328,94240,25
217000,79766,7289,7341,94396,25
217000,80128,7455,7489,95072,25
217000,79083,7425,7403,93911,26
217500,81195,7603,8448,97246,26
217500,80994,7557,7552,96103,26
217500,79671,7431,7420,94522,26
217500,79316,7292,7545,94153,26
217500,86827,8866,7689,103382,26
218000,84344,7245,7249,98838,26
218000,78480,7227,10170,95877,23
218000,77144,7198,7279,91621,23
218000,78736,7226,7281,93243,23
218000,78964,7292,7348,93604,25
218500,81319,7232,7270,95821,25
218500,78315,7247,7271,92833,25
218500,80149,7345,7380,94874,25
218500,82551,7815,7406,97772,22
218500,79235,7264,7261,93760,22
219000,79368,8799,7423,95590,22
219000,78475,7526,7380,93381,26
219000,79095,7340,7748,94183,26
219000,79822,7360,7390,94572,26
219000,79688,7388,7521,94597,26
219500,81732,7685,7439,96856,20
219500,79612,7384,7863,94859,20
219500,78865,7344,7415,93624,20
219500,80861,7346,7434,95641,33
219500,79697,7328,7570,94595,33
220000,79132,7379,7444,93955,33
220000,79156,7363,7415,93934,21
220000,79395,7669,7415,94479,21
220000,81108,7407,7437,95952,21
220000,84792,7376,7647,99815,21
220500,80086,7408,7547,95041,30
220500,79963,7390,7518,94871,30
220500,79543,7411,7438,94392,30
220500,80580,7803,8211,96594,25
220500,80038,7482,7429,94949,25
221000,79339,7441,7457,94237,25
221000,79304,7767,7442,94513,25
221000,79882,7570,7462,94914,25
221000,79893,7389,7452,94734,25
221000,79700,7391,7486,94577,25
221500,80231,7413,7474,95118,25
221500,80230,8364,7502,96096,25
221500,81467,7415,7484,96366,25
221500,80213,7409,7447,95069,28
221500,80613,7423,7510,95546,28
222000,83351,7570,7541,98462,28
222000,89123,7519,7534,104176,28
222000,80713,7465,9115,97293,26
222000,80886,7509,8313,96708,26
222000,82170,7593,7497,97260,26
222500,84072,7864,7751,99687,28
222500,82302,7649,7491,97442,28
222500,83972,7912,7904,99788,28
222500,82996,7528,7607,98131,24
222500,81337,7548,7604,96489,24
223000,81611,7459,7540,96610,24
223000,80046,7498,7507,95051,29
223000,80494,7521,7511,95526,29
223000,87194,7472,7999,102665,29
223000,83063,7741,7743,98547,29
223500,116706,7590,7554,131850,29
223500,81378,7599,9373,98350,29
223500,80058,7572,7513,95143,27
223500,80811,7546,7450,95807,27
223500,81923,7486,7533,96942,27
224000,81138,7474,7588,96200,30
224000,81610,7535,7584,96729,30
224000,85017,7941,8071,101029,30
224000,105826,10633,11062,127521,24
224000,81724,7605,7584,96913,24
224500,82973,7656,7688,98317,24
224500,96721,8242,8067,113030,31
224500,81295,7520,7561,96376,31
224500,104823,7957,7889,120669,31
224500,84467,7503,7799,99769,29
225000,88691,7504,7539,103734,29
225000,83947,7572,7753,99272,29
225000,95955,7577,7659,111191,28
225000,98003,7477,7619,113099,28
225000,81783,7966,7974,97723,28
225500,83009,7578,8812,99399,25
225500,85690,7828,7464,100982,25
225500,84748,7607,7677,100032,25
225500,82368,7707,7618,97693,27
225500,82667,7543,7598,97808,27
226000,82110,7599,7665,97374,27
226000,82169,7568,7594,97331,28
226000,89110,7567,7618,104295,28
226000,81544,21532,7655,110731,28
226000,82277,7619,7661,97557,31
226500,82737,7710,7636,98083,31
226500,83471,7585,7972,99028,31
226500,83099,7612,7663,98374,24
226500,89721,20331,13057,123109,24
226500,83341,7616,7657,98614,24
227000,81854,7688,7632,97174,24
227000,82295,7575,7638,97508,29
227000,82651,7717,7640,98008,29
227000,82231,7701,15963,105895,29
227000,102359,8677,8222,119258,26
227500,94678,7551,7627,109856,26
227500,85373,7534,7539,100446,26
227500,97330,9918,9377,116625,29
227500,98392,9383,9352,117127,29
227500,81357,7538,7552,96447,29
228000,82512,7636,7663,97811,29
228000,82119,7606,7647,97372,29
228000,83557,7656,8066,99279,22
228000,82290,7608,7687,97585,22
228000,82293,7631,7683,97607,22
228500,83238,7816,7764,98818,22
228500,84701,8368,8442,101511,30
228500,89273,8259,8282,105814,30
228500,101361,7711,7797,116869,30
228500,83794,7639,7692,99125,30
229000,82802,7567,7598,97967,30
229000,85234,7692,7694,100620,30
229000,86532,7982,8180,102694,32
229000,83460,7657,7713,98830,32
229000,83056,7932,7702,98690,32
229500,85747,7670,7771,101188,24
229500,84289,7657,7716,99662,24
229500,84371,7711,7720,99802,24
229500,82780,8018,7712,98510,21
229500,83473,7717,7711,98901,21
230000,83594,7697,7790,99081,21
230000,83294,7662,7734,98690,26
230000,86646,7729,7700,102075,26
230000,83151,7681,7715,98547,26
230000,83163,7687,7731,98581,26
230500,84663,7672,7784,100119,34
230500,83970,7675,7797,99442,34
230500,84265,7747,7742,99754,34
230500,84520,7743,7851,100114,26
230500,84450,7723,7761,99934,26
231000,83680,7689,7746,99115,26
231000,88296,7859,7933,104088,24
231000,84507,7752,7794,100053,24
231000,85767,7706,7761,101234,24
231000,84085,7804,7760,99649,29
231500,88972,7755,7772,104499,29
231500,84240,7734,7769,99743,29
231500,83334,7713,7784,98831,25
231500,84520,7725,7801,100046,25
231500,84732,7785,7769,100286,25
232000,83563,7740,7776,99079,25
232000,83523,7743,7840,99106,25
232000,84419,7758,8011,100188,25
232000,87352,7930,14664,109946,23
232000,84347,7738,7777,99862,23
232500,84318,7871,7807,99996,23
232500,84406,7757,8155,100318,23
232500,92454,10778,10728,113960,27
232500,86996,7801,8156,102953,27
232500,85049,7777,7842,100668,27
233000,86009,7766,7978,101753,30
233000,85074,9187,8087,102348,30
233000,85141,7794,7928,100863,30
233000,100540,8021,7913,116474,24
233000,103550,9645,7973,121168,24
233500,89989,11997,11042,113028,24
233500,85370,7913,7834,101117,24
233500,84038,7663,7700,99401,24
233500,87019,7820,7873,102712,24
233500,87087,7801,7845,102733,26
234000,85674,7883,7857,101414,26
234000,84818,7837,7862,100517,26
234000,86278,7797,7861,101936,22
234000,85767,7808,7855,101430,22
234000,87180,7827,7862,102869,22
234500,90294,7825,8959,107078,25
234500,84958,8555,7761,101274,25
234500,85350,7853,7956,101159,25
234500,94236,9989,8644,112869,25
234500,86316,7880,8097,102293,29
235000,108289,7919,8042,124250,29
235000,85211,7860,7897,100968,29
235000,85116,7855,7906,100877,29
235000,105650,8120,8030,121800,29
235000,84928,7896,7945,100769,23
235500,98126,7847,7967,113940,23
235500,85989,7877,7945,101811,23
235500,87044,7888,7905,102837,24
235500,87587,8232,7945,103764,24
235500,86355,7884,7958,102197,24
236000,87516,7880,7927,103323,24
236000,86646,7866,7944,102456,26
236000,86889,7975,7944,102808,26
236000,85967,7964,7955,101886,26
236000,87156,7943,8075,103174,24
236500,86811,8033,7978,102822,24
236500,86235,8128,7946,102309,24
236500,85859,7877,7979,101715,25
236500,87246,8768,8100,104114,25
236500,89518,7954,7912,105384,25
237000,85794,7855,7885,101534,27
237000,85742,7848,7908,101498,27
237000,88836,7939,7956,104731,27
237000,84738,9186,7850,101774,30
237000,88280,8372,8251,104903,30
237500,110392,10319,10360,131071,30
237500,92688,8147,8224,109059,31
237500,95107,9865,8376,113348,31
237500,97836,7948,8053,113837,27
237500,88655,7916,7992,104563,27
238000,89732,8245,8286,106263,27
238000,90079,8550,8346,106975,28
238000,92085,8136,8747,108968,28
238000,95615,12753,15710,124078,28
238000,88798,8039,9470,106307,32
238500,86316,7905,7938,102159,32
238500,90175,7791,7911,105877,32
238500,95756,8101,8157,112014,30
238500,98125,8357,8302,114784,30
238500,89661,7943,8021,105625,27
239000,87530,7962,8031,103523,27
239000,87274,7945,9974,105193,27
239000,98204,8088,8136,114428,27
239000,109098,8955,8248,126301,30
239000,87446,8336,7995,103777,30
239500,89151,7951,7953,105055,30
239500,88081,7990,8026,104097,30
239500,101530,8052,8100,117682,30
239500,88733,7903,8006,104642,24
239500,87914,7876,8623,104413,24
240000,89897,8014,8060,105971,24
240000,90273,8429,8448,107150,30
240000,103720,8113,8156,119989,30
240000,87665,7941,7972,103578,30
240000,119046,8025,8931,136002,26
240500,103925,8081,8419,120425,26
240500,89251,7914,8037,105202,24
240500,87018,7947,8015,102980,24
240500,107115,12426,12544,132085,24
240500,109944,10047,10053,130044,27
241000,89916,8013,8078,106007,27
241000,89812,8162,8080,106054,27
241000,87216,8006,8078,103300,29
241000,90473,8044,8277,106794,29
241000,87361,8069,8088,103518,29
241500,90188,8387,8096,106671,30
241500,98369,8518,8660,115547,30
241500,90458,8144,10956,109558,30
241500,93047,8767,10766,112580,24
241500,98725,10541,10129,119395,24
242000,92908,8089,8334,109331,31
242000,89454,8127,8417,105998,31
242000,98010,9714,10419,118143,31
242000,88547,8083,18993,115623,30
242000,94907,8379,8193,111479,30
242500,90459,8921,8683,108063,24
242500,93312,8155,9805,111272,24
242500,93623,8111,8219,109953,24
242500,88627,9529,18381,116537,24
242500,91132,10054,8317,109503,25
243000,93173,8044,8322,109539,25
243000,89332,8029,8402,105763,25
243000,104525,9352,8241,122118,26
243000,117539,8536,8145,134220,26
243000,87626,34431,12278,134335,27
243500,102295,8576,8102,118973,27
243500,88836,8144,8151,105131,27
243500,91877,8290,8466,108633,25
243500,92144,8088,8191,108423,25
243500,94765,8554,8209,111528,25
244000,100884,8255,8209,117348,25
244000,95218,8922,8212,112352,25
244000,90837,8264,8147,107248,25
244000,118336,8609,8933,135878,31
244000,92701,8273,9010,109984,31
244500,93954,8209,8551,110714,31
244500,88348,8152,8190,104690,29
244500,91376,8303,8419,108098,29
244500,93192,8101,8209,109502,26
244500,88688,8052,8187,104927,26
245000,93760,8288,8306,110354,26
245000,91240,8306,8807,108353,30
245000,91166,8218,8172,107556,30
245000,90705,8095,8144,106944,30
245000,88989,8248,8198,105435,28
245500,89435,8188,8203,105826,28
245500,89197,8177,8229,105603,28
245500,89116,8184,8202,105502,23
245500,93049,8165,8231,109445,23
245500,89589,8156,8235,105980,23
246000,90597,8188,8258,107043,23
246000,92921,8381,10108,111410,23
246000,98175,8092,8129,114396,23
246000,89159,24732,15001,128892,26
246000,98475,8439,8390,115304,26
246500,87994,8104,8159,104257,26
246500,90523,8176,8568,107267,25
246500,89978,8177,8443,106598,25
246500,93106,8262,8389,109757,25
246500,99634,12225,9498,121357,31
247000,116546,11032,12519,140097,31
247000,88813,8170,8193,105176,31
247000,96937,10597,10711,118245,29
247000,106058,10372,8214,124644,29
247000,92123,8114,8308,108545,33
247500,91630,8235,8305,108170,33
247500,90183,8346,8417,106946,33
247500,93453,8268,8391,110112,26
247500,94355,8310,8290,110955,26
247500,94066,8755,8308,111129,26
248000,100270,8260,8711,117241,34
248000,98786,9085,8744,116615,34
248000,91339,8280,8425,108044,26
248000,91205,8365,8473,108043,26
248000,93271,8282,8329,109882,26
248500,92752,8518,8850,110120,26
248500,93703,8870,9684,112257,26
248500,92804,8548,8378,109730,26
248500,105952,8451,10156,124559,29
248500,91104,8173,8396,107673,29
249000,93076,8339,8366,109781,29
249000,110028,9904,9904,129836,28
249000,93076,8469,8971,110516,28
249000,99649,10888,8472,119009,27
249000,120188,11946,8896,141030,27
249500,99054,9060,8834,116948,27
249500,96541,8730,8991,114262,25
249500,93238,8246,9151,110635,25
249500,92543,8165,8258,108966,25
249500,100044,8335,8826,117205,31
250000,93377,8562,8452,110391,31
250000,94284,8537,8623,111444,28
250000,92814,8366,8502,109682,28
250000,93417,8317,8379,110113,28
250000,104077,10631,10020,124728,26
250500,92528,8321,8634,109483,26
250500,92409,9006,8533,109948,26
250500,96197,8427,8455,113079,26
250500,96574,12310,11482,120366,26
250500,98563,9320,9451,117334,26
251000,96460,9414,10114,115988,26
251000,117814,9446,10177,137437,26
251000,98808,8569,8756,116133,25
251000,92280,8253,8458,108991,25
251000,92538,8684,8448,109670,25
251500,92560,8278,8330,109168,31
251500,91946,8659,8355,108960,31
251500,93594,8383,8442,110419,31
251500,100324,8435,8509,117268,35
251500,93350,8496,8437,110283,35
252000,96688,8399,8456,113543,30
252000,93784,8385,8417,110586,30
252000,92648,8513,8946,110107,30
252000,97708,8606,8956,115270,26
252000,101245,16459,10946,128650,26
252500,96255,8671,8456,113382,22
252500,97895,9363,8833,116091,22
252500,98291,8931,8623,115845,22
252500,117810,9304,8770,135884,26
252500,95059,8456,9077,112592,26
253000,100822,10214,8749,119785,26
253000,94696,8716,9052,112464,25
253000,94931,8534,9016,112481,25
253000,124649,9051,8503,142203,25
253000,101762,9726,8656,120144,33
253500,96187,9601,8747,114535,33
253500,96280,8747,8647,113674,23
253500,96693,8669,8616,113978,23
253500,102214,8375,8479,119068,23
253500,107225,8977,8531,124733,25
254000,95743,8363,8630,112736,25
254000,101749,8723,9371,119843,25
254000,95006,8608,9100,112714,24
254000,95172,8498,8910,112580,24
254000,97911,8805,8517,115233,24
254500,95653,8495,8553,112701,21
254500,97536,8621,8880,115037,21
254500,98267,9262,8915,116444,21
254500,99415,8593,9113,117121,24
254500,130543,12119,12798,155460,24
255000,95474,8618,8585,112677,24
255000,129678,10756,11467,151901,19
255000,101333,12262,10102,123697,19
255000,99719,16565,13005,129289,19
255000,96355,8638,8582,113575,25
255500,118684,9948,10781,139413,25
255500,96425,8870,8698,113993,25
255500,95334,9167,8644,113145,26
255500,102870,8842,9757,121469,26
255500,95211,8779,8848,112838,26
256000,96208,8679,8766,113653,30
256000,95603,8805,9284,113692,30
256000,95202,8541,9495,113238,31
256000,95531,8625,8647,112803,31
256000,98109,8897,8608,115614,31
256500,99794,8683,8613,117090,29
256500,97966,8670,9758,116394,29
256500,96607,8529,8628,113764,24
256500,96985,8568,8581,114134,24
256500,98357,9830,8625,116812,24
257000,95758,8855,8690,113303,29
257000,95821,8573,8941,113335,29
257000,96090,8533,8584,113207,29
257000,95937,8878,8876,113691,34
257000,95965,8818,9018,113801,34
257500,97931,8889,8613,115433,33
257500,96547,8719,9232,114498,33
257500,95767,8955,8831,113553,33
257500,96790,9675,8979,115444,28
257500,96406,8865,9275,114546,28
258000,97224,8647,9306,115177,28
258000,98951,9025,8891,116867,20
258000,96813,8579,8744,114136,20
258000,99597,8858,9140,117595,20
258000,96870,9018,9145,115033,30
258500,99505,8617,10071,118193,30
258500,101489,9237,9168,119894,25
258500,101956,8789,9628,120373,25
258500,98651,8889,9585,117125,25
258500,100413,8752,8917,118082,33
259000,98281,8838,11599,118718,33
259000,100024,8708,9490,118222,27
259000,99210,8642,9487,117339,27
259000,97309,8667,8737,114713,27
259000,99286,9628,8925,117839,31
259500,96997,8698,8682,114377,31
259500,96439,9043,9526,115008,31
259500,99944,8643,8848,117435,25
259500,98959,8692,8819,116470,25
259500,98960,8841,8806,116607,30
260000,98647,8547,8647,115841,31
260000,98822,11022,11429,121273,31
260000,100529,8644,8728,117901,23
260000,117534,8578,8958,135070,23
260000,96117,9209,8789,114115,23
260500,99360,8708,8800,116868,32
260500,104570,9203,8755,122528,32
260500,99297,9971,19417,128685,31
260500,102666,10156,11783,124605,31
260500,98070,8623,8845,115538,22
261000,98470,9416,8863,116749,22
261000,98221,8640,8742,115603,22
261000,99117,16028,13568,128713,27
261000,99548,8762,9760,118070,27
261000,103189,9099,9205,121493,27
261500,101525,8853,8896,119274,29
261500,99138,9113,8952,117203,29
261500,99857,9042,8900,117799,29
261500,100724,9050,10499,120273,30
261500,100557,8788,9267,118612,30
262000,98473,8872,9482,116827,29
262000,98320,9192,9459,116971,29
262000,100265,8723,8874,117862,29
262000,99417,8624,9617,117658,19
262000,100855,8750,9009,118614,19
262500,98252,8961,8790,116003,19
262500,98556,9072,8867,116495,32
262500,101212,9078,9164,119454,32
262500,97765,9013,9357,116135,30
262500,99422,8750,8819,116991,30
263000,101705,8933,9864,120502,30
263000,100534,8780,9537,118851,23
263000,106488,8779,9431,124698,23
263000,97417,8642,8747,114806,23
263000,100141,8703,8756,117600,25
263500,98748,9907,9765,118420,25
263500,103033,8671,8855,120559,28
263500,180943,16539,15570,213052,28
263500,103553,10313,9315,123181,28
263500,101212,8667,10423,120302,24
264000,99522,9008,8899,117429,24
264000,100432,8722,8946,118100,27
264000,98671,9411,9063,117145,27
264000,99363,8743,8866,116972,27
264000,100814,9352,11804,121970,25
264500,102925,8712,8782,120419,25
264500,107362,13485,10715,131562,24
264500,115948,9423,8948,134319,24
264500,103238,9904,9134,122276,24
264500,98952,9586,8863,117401,29
265000,98625,9086,9260,116971,29
265000,100185,8829,9010,118024,29
265000,99353,9265,8911,117529,32
265000,125995,9583,10255,145833,32
265000,102159,8832,8885,119876,33
265500,99466,8779,8866,117111,33
265500,99771,8826,8838,117435,29
265500,99826,8813,8914,117553,29
265500,102647,9101,9199,120947,29
265500,99606,8773,9800,118179,29
266000,100765,8875,9040,118680,29
266000,114418,16365,12603,143386,27
266000,165081,15616,19566,200263,27
266000,150214,15719,14896,180829,29
266000,163999,9472,9334,182805,29
266500,100636,10244,9588,120468,32
266500,122724,9724,9965,142413,32
266500,105025,9204,9993,124222,29
266500,102529,9966,11354,123849,29
266500,102167,8944,8946,120057,29
267000,147494,13586,13652,174732,33
267000,121668,13530,12727,147925,33
267000,127619,15435,15653,158707,26
267000,134869,16786,16812,168467,26
267000,163734,8881,8976,181591,23
267500,109886,9054,9367,128307,23
267500,121672,9091,9554,140317,27
267500,129889,8912,9294,148095,27
267500,104176,8964,8889,122029,25
267500,99983,8766,8856,117605,25
268000,107002,16535,17473,141010,25
268000,98980,11664,10330,120974,27
268000,107072,14702,9006,130780,27
268000,114072,12442,10169,136683,25
268000,106103,12840,11614,130557,25
268500,118192,9743,8926,136861,25
268500,101701,9003,8949,119653,29
268500,112108,8863,9249,130220,29
268500,107335,9590,9768,126693,27
268500,101300,8964,9337,119601,27
269000,100790,9045,8973,118808,27
269000,101864,8986,8951,119801,29
269000,104799,9303,9223,123325,29
269000,99749,9433,9039,118221,19
269000,107492,9085,8950,125527,19
269500,104592,9219,11059,124870,19
269500,98266,8841,9069,116176,24
269500,102250,8868,8947,120065,24
269500,106125,11713,12541,130379,24
269500,98499,9046,8987,116532,22
270000,101057,8851,9683,119591,22
270000,99044,9705,9556,118305,22
270000,107549,8955,9008,125512,23
270000,102122,9257,10078,121457,23
270000,101551,9397,9312,120260,23
270500,100182,8960,9016,118158,25
270500,102310,9499,9007,120816,25
270500,101602,9651,11656,122909,25
270500,116254,9307,9321,134882,29
270500,114252,11706,12529,138487,29
271000,108961,10214,10005,129180,23
271000,111557,9239,9546,130342,23
271000,101185,9361,9729,120275,23
271000,106916,9190,9365,125471,27
271000,106787,9258,9063,125108,27
271500,100843,9190,9031,119064,25
271500,102370,11067,9201,122638,25
271500,106195,8912,9136,124243,25
271500,101651,9650,9225,120526,27
271500,110189,8902,9561,128652,27
272000,116910,9367,9628,135905,27
272000,107762,9469,9107,126338,29
272000,104495,9096,9238,122829,29
272000,102267,9119,9209,120595,29
272000,107237,9252,9281,125770,29
272500,101977,9203,9304,120484,29
272500,101651,9129,9104,119884,24
272500,113122,9112,9412,131646,24
272500,102603,9254,9140,120997,29
272500,101257,9469,9339,120065,29
273000,102081,9222,9513,120816,29
273000,102021,9805,9171,120997,26
273000,104910,9300,9227,123437,26
273000,106534,9187,9273,124994,26
273000,102157,9416,9084,120657,26
273500,103827,10127,9188,123142,27
273500,102231,9053,9192,120476,27
273500,102344,9298,9411,121053,27
273500,100666,9971,9496,120133,27
273500,104734,8962,9026,122722,25
274000,107660,8965,9062,125687,25
274000,104532,9783,9170,123485,27
274000,119906,9201,9322,138429,27
274000,105151,9208,9520,123879,27
274000,105124,9445,9117,123686,25
274500,105007,9377,9335,123719,25
274500,103158,9538,9161,121857,36
274500,104311,9131,9132,122574,36
274500,102789,9069,9191,121049,36
274500,102391,9324,9161,120876,21
275000,105245,9652,9508,124405,21
275000,102405,9089,9920,121414,21
275000,102834,9232,9334,121400,21
275000,102384,9257,9328,120969,21
275000,108008,9160,9319,126487,29
275500,102877,9167,9193,121237,29
275500,105107,9805,9395,124307,29
275500,104865,9152,9451,123468,24
275500,104746,9348,9235,123329,24
275500,105940,9547,9451,124938,28
276000,106470,9334,9185,124989,28
276000,104758,9109,9915,123782,28
276000,106614,9162,9203,124979,19
276000,105742,10086,9396,125224,19
276000,104367,9166,9240,122773,19
276500,109801,9546,9406,128753,23
276500,103912,9182,9408,122502,23
276500,102887,9194,9184,121265,23
276500,104269,9584,9745,123598,32
276500,103478,9184,9355,122017,32
277000,104308,9149,9331,122788,27
277000,107951,8996,9171,126118,27
277000,105499,9375,10332,125206,27
277000,104576,9181,10096,123853,19
277000,103308,9398,9703,122409,19
277500,102439,9169,9237,120845,19
277500,106276,9360,9255,124891,26
277500,105238,9191,9236,123665,26
277500,103361,9512,9239,122112,26
277500,110944,9106,9138,129188,25
278000,103259,9169,10308,122736,25
278000,103739,9148,9238,122125,23
278000,104277,9240,9286,122803,23
278000,102774,9100,9478,121352,23
278000,102524,9967,9181,121672,26
278500,106440,9234,9516,125190,26
278500,106755,9197,9272,125224,26
278500,104416,9666,9807,123889,20
278500,104854,9241,9495,123590,20
278500,112844,9471,9754,132069,23
279000,143290,9248,9389,161927,23
279000,116024,9310,9341,134675,23
279000,109974,10984,9912,130870,30
279000,107775,9342,9835,126952,30
279000,111643,9318,9540,130501,29
279500,109896,10191,9959,130046,29
279500,106875,9237,10199,126311,29
279500,105798,9821,9744,125363,26
279500,110072,9353,9661,129086,26
279500,111573,10365,9538,131476,26
280000,109486,9279,9667,128432,26
280000,111490,9497,9541,130528,26
280000,105282,9256,9345,123883,28
280000,111796,9661,9437,130894,28
280000,107474,9497,10530,127501,30
280500,107900,9502,9993,127395,30
280500,106068,9713,9887,125668,30
280500,106677,9268,9985,125930,28
280500,107026,10068,9975,127069,28
280500,105621,9275,9494,124390,32
281000,106975,9385,10874,127234,32
281000,107964,9626,9388,126978,22
281000,107006,9602,9461,126069,22
281000,105851,9475,9358,124684,22
281000,121757,9478,9552,140787,28
281500,113289,9290,9701,132280,28
281500,110488,10398,11015,131901,28
281500,105978,9514,10086,125578,31
281500,107086,9804,10135,127025,31
281500,104659,9238,9248,123145,28
282000,116241,9350,9306,134897,28
282000,106492,9593,9399,125484,32
282000,114256,9819,9290,133365,32
282000,121809,9459,9656,140924,32
282000,106454,9402,9543,125399,24
282500,111618,9840,9907,131365,24
282500,108693,9608,9359,127660,32
282500,110185,9552,9379,129116,32
282500,110626,9375,9408,129409,25
282500,107425,9922,10066,127413,25
283000,116281,9959,9634,135874,25
283000,106183,9354,9397,124934,25
283000,110684,9490,10608,130782,25
283000,107253,9707,9709,126669,25
283000,106034,9368,9411,124813,31
283500,106333,9847,9511,125691,31
283500,105792,9993,9426,125211,28
283500,107513,9756,9494,126763,28
283500,129649,9404,9444,148497,24
283500,108420,9787,10199,128406,24
284000,107338,9420,9784,126542,24
284000,108759,9395,9614,127768,26
284000,108097,9621,9613,127331,26
284000,107127,9592,11435,128154,26
284000,126167,9490,10881,146538,30
284500,108113,9388,9526,127027,30
284500,110663,10380,9837,130880,25
284500,109469,9447,9473,128389,25
284500,108566,9798,9713,128077,25
284500,107790,9590,9579,126959,29
285000,110475,9424,9689,129588,29
285000,111088,11059,9764,131911,19
285000,107656,9506,9641,126803,19
285000,108355,9383,9582,127320,19
285000,111753,9418,10047,131218,30
285500,107699,9503,10096,127298,30
285500,107686,9929,9788,127403,24
285500,108614,9760,9960,128334,24
285500,107813,9406,9662,126881,24
285500,120965,9921,11276,142162,31
286000,107958,9475,9568,127001,31
286000,106520,9484,9641,125645,26
286000,106888,9844,9603,126335,26
286000,107021,9907,9479,126407,26
286000,106035,9441,9477,124953,27
286500,107986,9433,9705,127124,27
286500,110968,9490,9548,130006,20
286500,108788,9524,9510,127822,20
286500,112317,10528,10285,133130,20
286500,108477,12035,10556,131068,27
287000,107124,9600,9521,126245,27
287000,107738,9692,9718,127148,27
287000,119465,13574,14042,147081,20
287000,108832,9561,10006,128399,20
287000,107711,10091,9700,127502,20
287500,108036,9441,9620,127097,24
287500,109209,9862,9750,128821,24
287500,109710,9768,9721,129199,25
287500,108469,9632,9717,127818,25
287500,108109,10074,10332,128515,25
288000,109542,9828,9758,129128,27
288000,107836,9664,9733,127233,27
288000,108678,10486,9736,128900,20
288000,107372,9550,9586,126508,20
288000,108131,9493,9563,127187,20
288500,109146,9498,9781,128425,34
288500,109831,9777,9557,129165,34
288500,110499,9730,9872,130101,34
288500,108581,9648,9575,127804,27
288500,108390,9508,10115,128013,27
289000,110228,9537,10216,129981,26
289000,109993,9615,10390,129998,26
289000,109139,10110,9617,128866,24
289000,108320,9541,9972,127833,24
289000,108389,9970,9763,128122,24
289500,110486,10502,9638,130626,33
289500,112733,9885,10553,133171,33
289500,112668,9576,9580,131824,29
289500,110309,9971,9968,130248,29
289500,115288,10255,9616,135159,29
290000,116133,9657,9958,135748,29
290000,110210,9601,9611,129422,29
290000,109590,10046,9966,129602,22
290000,121638,9678,10207,141523,22
290000,110098,10593,11445,132136,27
290500,112212,12224,10048,134484,27
290500,117233,9595,10096,136924,27
290500,110411,9796,9657,129864,31
290500,111068,9670,9625,130363,31
290500,109088,9566,9616,128270,24
291000,111207,10193,9744,131144,24
291000,112235,9642,9848,131725,24
291000,110961,9933,9632,130526,33
291000,110316,10491,9889,130696,33
291000,111965,11644,12845,136454,30
291500,114834,12473,10333,137640,30
291500,113269,9657,12657,135583,30
291500,112946,9623,9877,132446,30
291500,110272,9619,9822,129713,30
291500,112353,9650,10099,132102,26
292000,117708,11535,10470,139713,26
292000,113205,9637,9781,132623,23
292000,114191,9877,10232,134300,23
292000,114826,9993,10002,134821,23
292000,109876,9628,10390,129894,26
292500,111909,9841,10028,131778,26
292500,114438,9852,10250,134540,29
292500,111828,10886,10308,133022,29
292500,110742,9780,9589,130111,25
292500,109801,9760,9825,129386,25
293000,109878,9718,9657,129253,25
293000,118177,10516,9920,138613,26
293000,113884,9887,10186,133957,26
293000,113498,9703,10634,133835,28
293000,110676,10365,10219,131260,28
293500,110958,9696,9708,130362,28
293500,121085,9663,9855,140603,23
293500,114880,10527,9969,135376,23
293500,110696,10180,10747,131623,29
293500,114974,9952,10380,135306,29
294000,125585,14348,15018,154951,29
294000,116783,12411,10530,139724,27
294000,112515,9701,10099,132315,27
294000,113421,10049,9799,133269,19
294000,118000,10253,9825,138078,19
294500,113590,9842,9914,133346,19
294500,140649,10620,9619,160888,29
294500,111898,10067,9958,131923,29
294500,119971,9619,9794,139384,25
294500,130762,11813,9954,152529,25
295000,110196,11366,10240,131802,18
295000,116406,9701,11159,137266,18
295000,118105,10505,9778,138388,18
295000,114584,10009,9788,134381,24
295000,113967,11198,10149,135314,24
295500,111672,9711,10749,132132,24
295500,112695,9958,9888,132541,27
295500,110941,9832,10032,130805,27
295500,112506,9937,10472,132915,30
295500,111502,9748,9765,131015,30
296000,113777,9816,9859,133452,30
296000,113250,9882,10535,133667,27
296000,113300,10539,10204,134043,27
296000,113560,9973,9790,133323,25
296000,113514,9734,11257,134505,25
296500,114616,9768,10040,134424,25
296500,112882,10355,10322,133559,25
296500,137904,13320,9963,161187,25
296500,115225,10017,10243,135485,26
296500,113651,9868,10416,133935,26
297000,114237,9902,10259,134398,23
297000,112556,9967,9812,132335,23
297000,118059,11203,9989,139251,23
297000,114681,9924,9837,134442,22
297000,113896,9901,10433,134230,22
297500,111031,10460,9919,131410,25
297500,112671,9784,10080,132535,25
297500,113118,10012,9986,133116,25
297500,135325,12299,12534,160158,23
297500,111712,10804,11122,133638,23
298000,115372,9969,9928,135269,19
298000,113819,9844,9922,133585,19
298000,113385,9817,10343,133545,19
298000,118286,10696,10061,139043,25
298000,115989,9950,10028,135967,25
298500,116025,10612,9973,136610,25
298500,114853,9902,10211,134966,29
298500,115043,9866,10056,134965,29
298500,116112,9963,10036,136111,24
298500,118356,9842,10209,138407,24
299000,114632,9832,10278,134742,24
299000,115533,10079,9947,135559,22
299000,123874,9865,10105,143844,22
299000,114700,10618,10712,136030,23
299000,113481,10456,10272,134209,23
299500,194120,16968,18869,229957,23
299500,114387,10644,9976,135007,23
299500,185786,13736,13417,212939,23
299500,178391,13587,10915,202893,26
299500,118104,10182,9962,138248,26
300000,115431,10090,10201,135722,29
300000,115641,10115,10118,135874,29
300000,179955,9885,9941,199781,33
300000,194403,18575,17185,230163,33
300000,114072,9990,13125,137187,23
300500,140487,9913,10106,160506,23
300500,115859,14425,14754,145038,26
300500,128203,12562,12680,153445,26
300500,113318,9872,9879,133069,26
300500,157878,10165,17584,185627,26
301000,170784,12031,11045,193860,23
301000,116154,10467,10005,136626,23
301000,164920,11552,10649,187121,31
301000,116263,11077,10094,137434,31
301000,118563,10798,11336,140697,27
301500,114390,9845,10756,134991,27
301500,114378,10097,9898,134373,31
301500,162376,10292,10384,183052,31
301500,135401,13509,11039,159949,23
301500,116439,10181,9995,136615,23
302000,145447,9815,10736,165998,26
302000,113473,11236,10123,134832,26
302000,118294,10618,10318,139230,26
302000,120649,9903,9930,140482,26
302000,114250,11210,10562,136022,26
302500,116386,9808,10420,136614,26
302500,116866,9987,10022,136875,26
302500,113951,10120,11214,135285,27
302500,113828,10136,12313,136277,27
302500,114225,10007,10209,134441,27
303000,113138,10221,10298,133657,31
303000,115064,10262,10295,135621,31
303000,130532,10157,10614,151303,29
303000,114680,9981,10094,134755,29
303000,117077,10085,10007,137169,23
303500,116358,10119,10156,136633,23
303500,209398,17969,16970,244337,23
303500,175335,16897,15941,208173,23
303500,148625,10156,10354,169135,25
303500,117673,18229,18125,154027,25
304000,113736,10007,10070,133813,21
304000,118224,10380,10122,138726,21
304000,126339,10117,10364,146820,21
304000,120325,9994,10093,140412,27
304000,123210,9934,10184,143328,27
304500,139715,13720,16303,169738,22
304500,117416,10232,10148,137796,22
304500,115210,9964,10210,135384,21
304500,172063,17453,15834,205350,21
304500,168715,15998,16054,200767,30
305000,117677,9953,10487,138117,30
305000,113854,9950,10723,134527,26
305000,115547,10002,10122,135671,26
305000,116884,12927,17443,147254,29
305000,121680,10490,10899,143069,29
305500,119261,10852,10081,140194,18
305500,134307,10224,11005,155536,18
305500,151809,14534,15777,182120,18
305500,118070,10122,10434,138626,33
305500,162568,12263,16949,191780,33
306000,139321,11513,11227,162061,23
306000,118180,10736,10524,139440,23
306000,131955,10069,10353,152377,28
306000,115683,10183,11153,137019,28
306000,154135,10824,10277,175236,30
306500,132012,14595,14268,160875,30
306500,138695,18205,15160,172060,29
306500,113932,10003,11207,135142,29
306500,141453,10300,12061,163814,22
306500,117107,10232,10185,137524,22
307000,117539,10706,10214,138459,22
307000,129456,10252,14093,153801,22
307000,116443,10200,10158,136801,22
307000,220761,16991,24557,262309,21
307000,170442,14266,10265,194973,21
307500,137878,17409,20516,175803,22
307500,173066,14907,18454,206427,22
307500,123627,11591,10423,145641,24
307500,204527,10251,10512,225290,24
307500,122727,10695,11176,144598,28
308000,118292,10078,10162,138532,28
308000,134961,17960,14972,167893,22
308000,185828,16439,18196,220463,22
308000,144387,11118,10531,166036,25
308000,176801,16205,17510,210516,31
308500,180915,11658,11448,204021,31
308500,150700,16829,19969,187498,26
308500,154125,10402,10193,174720,26
308500,117744,11509,10249,139502,27
308500,153694,14397,10793,178884,27
309000,120629,10108,14093,144830,24
309000,147737,10129,10329,168195,24
309000,127302,11051,10950,149303,27
309000,120838,10175,10280,141293,27
309000,134635,11284,13567,159486,30
309500,119559,10713,10280,140552,30
309500,132760,10221,10260,153241,21
309500,119459,10761,10237,140457,21
309500,118139,10234,10438,138811,25
309500,177036,14867,15440,207343,25
310000,117959,10808,10372,139139,25
310000,119010,10888,10229,140127,27
310000,121017,10384,10516,141917,27
310000,118012,10195,10475,138682,24
310000,119943,10471,11556,141970,24
310500,123769,10458,10389,144616,21
310500,118622,10225,10265,139112,21
310500,121439,10873,10738,143050,21
310500,123221,10834,10459,144514,27
310500,121232,11568,10953,143753,27
311000,120220,10267,10255,140742,31
311000,124735,10479,10388,145602,31
311000,134352,10418,10599,155369,25
311000,121795,11363,10701,143859,25
311000,120295,10855,10759,141909,25
311500,119590,10216,10712,140518,28
311500,121615,10353,10450,142418,28
311500,118461,10261,10318,139040,26
311500,118697,11324,11192,141213,26
311500,118763,11349,10541,140653,35
312000,121549,10483,10892,142924,35
312000,119748,10314,10793,140855,19
312000,123947,10438,13326,147711,19
312000,121383,10270,10304,141957,19
312000,138185,10297,10321,158803,26
312500,126730,10166,10267,147163,26
312500,120241,10803,10940,141984,26
312500,119935,10922,10671,141528,26
312500,127611,10344,11031,148986,26
312500,122236,10274,10606,143116,26
313000,120708,10570,10691,141969,26
313000,119093,10513,11327,140933,25
313000,122090,21757,13581,157428,25
313000,123981,10419,10603,145003,28
313000,123438,10433,10316,144187,28
313500,118813,11274,11028,141115,18
313500,125795,11961,10568,148324,18
313500,124482,10265,10587,145334,18
313500,120029,10324,10348,140701,24
313500,130654,12247,10446,153347,24
314000,120930,10687,10512,142129,22
314000,121864,10465,10712,143041,22
314000,120651,10284,10768,141703,22
314000,122644,10518,11355,144517,28
314000,124419,10932,10341,145692,28
314500,123160,10343,10456,143959,27
314500,119446,10595,10520,140561,27
314500,121826,10532,10741,143099,25
314500,121248,10445,10399,142092,25
314500,125353,10982,10862,147197,25
315000,126983,15002,14014,155999,29
315000,143747,13576,13882,171205,29
315000,120087,10883,10750,141720,25
315000,119446,10474,10683,140603,25
315000,120389,10415,10665,141469,30
315500,127730,13630,13523,154883,30
315500,144722,12620,13591,170933,24
315500,123710,10489,10364,144563,24
315500,131235,13845,13999,159079,23
315500,134156,10561,11078,155795,23
316000,124157,10861,10535,145553,23
316000,122087,10592,10856,143535,34
316000,122390,11024,10453,143867,34
316000,124964,10464,12154,147582,25
316000,121504,10888,10463,142855,25
316500,119889,10503,10547,140939,26
316500,123268,10772,10472,144512,26
316500,141537,10668,12808,165013,29
316500,127033,11338,10574,148945,29
316500,123316,10552,11121,144989,27
317000,124723,10550,10969,146242,27
317000,121494,10497,11669,143660,27
317000,132660,12835,12690,158185,31
317000,121234,10395,10468,142097,31
317000,124170,10553,10593,145316,33
317500,123624,11682,10684,145990,28
317500,122699,14343,14021,151063,28
317500,120663,10331,12442,143436,28
317500,119945,10822,10692,141459,30
317500,121681,10955,10643,143279,30
318000,119017,10372,10411,139800,30
318000,120728,10415,10979,142122,30
318000,122650,10414,11178,144242,30
318000,120787,10963,10566,142316,30
318000,123112,10424,10869,144405,29
318500,127750,11680,10965,150395,29
318500,136105,10465,10429,156999,26
318500,155087,10375,10605,176067,26
318500,122082,10783,10735,143600,32
318500,126810,10655,10576,148041,32
319000,122351,10581,10656,143588,22
319000,123769,10493,11071,145333,22
319000,130478,12496,13563,156537,22
319000,128529,15365,13043,156937,32
319000,128817,10619,10687,150123,32
319500,128631,12823,10839,152293,30
319500,129508,10871,10700,151079,30
319500,128834,11027,11182,151043,31
319500,123245,10764,10803,144812,26
319500,121372,10496,10607,142475,26
320000,123310,10539,10527,144376,26
320000,121132,10648,10734,142514,28
320000,135194,10493,10589,156276,28
320000,127343,10440,10508,148291,23
320000,134832,10516,11580,156928,23
320500,130986,10541,11403,152930,18
320500,123795,10810,10680,145285,18
320500,124823,10827,11705,147355,18
320500,125597,11522,12272,149391,32
320500,124632,10587,11515,146734,32
321000,133136,10833,11218,155187,30
321000,125494,10577,10571,146642,30
321000,132097,11164,10737,153998,22
321000,147022,11030,11265,169317,22
321000,121753,10621,10547,142921,25
321500,125172,10680,10596,146448,25
321500,124359,10724,11151,146234,25
321500,141267,11060,11355,163682,28
321500,125433,11005,10672,147110,28
321500,131122,10348,10644,152114,32
322000,124659,10591,12029,147279,32
322000,128539,10931,11133,150603,24
322000,136790,12858,11075,160723,24
322000,133931,13703,13722,161356,24
322000,145120,11918,11338,168376,24
322500,127164,12094,10659,149917,28
322500,125739,10569,11225,147533,28
322500,149456,10575,10786,170817,22
322500,123341,11519,10673,145533,22
322500,121820,11525,11701,145046,22
323000,123051,10507,11163,144721,31
323000,128481,10925,10953,150359,31
323000,122796,10562,12295,145653,27
323000,141820,11474,10785,164079,27
323000,129118,11435,10903,151456,26
323500,127147,11949,10960,150056,26
323500,135112,11516,11820,158448,20
323500,138960,11609,11388,161957,20
323500,133446,10619,10652,154717,28
323500,126447,10579,10685,147711,28
324000,125425,10916,10747,147088,24
324000,134384,10692,11304,156380,24
324000,148753,11865,10987,171605,24
324000,125220,10775,11343,147338,30
324000,128831,11528,10846,151205,30
324500,125326,11199,11009,147534,28
324500,124646,11048,14707,150401,28
324500,155003,10911,11339,177253,26
324500,125600,11599,11392,148591,26
324500,134242,10965,11488,156695,34
325000,127280,11140,12207,150627,34
325000,128447,10910,11067,150424,28
325000,124422,11126,11435,146983,28
325000,128441,11145,11066,150652,25
325000,127087,10954,11050,149091,25
325500,147961,13792,13652,175405,31
325500,126509,10718,11067,148294,31
325500,127837,10677,10727,149241,34
325500,134811,14453,14413,163677,34
325500,141711,10758,11716,164185,28
326000,132566,10938,11205,154709,28
326000,126427,10949,10688,148064,32
326000,126454,10780,10690,147924,32
326000,126943,10864,11192,148999,24
326000,128765,10753,10709,150227,24
326500,125765,12388,12265,150418,30
326500,129199,10738,10843,150780,30
326500,145341,11437,10917,167695,28
326500,125685,11104,10826,147615,28
326500,128563,11191,10815,150569,24
327000,128471,11003,10809,150283,24
327000,125528,11010,10819,147357,26
327000,123639,12932,10945,147516,26
327000,124286,10678,10776,145740,26
327000,127091,11130,10807,149028,28
327500,138859,18839,19818,177516,28
327500,182785,15429,16511,214725,24
327500,161944,18512,18977,199433,24
327500,161154,18427,16756,196337,24
327500,173587,19156,13029,205772,36
328000,126568,11831,11720,150119,36
328000,128918,10884,11505,151307,26
328000,148568,10837,10953,170358,25
328000,126392,10935,10992,148319,25
328000,127908,11335,10944,150187,25
328500,127283,11154,10940,149377,21
328500,127566,11196,11049,149811,21
328500,131866,13170,12321,157357,21
328500,125841,13839,14170,153850,21
328500,126506,10762,12379,149647,25
329000,190062,11181,10867,212110,25
329000,126807,10712,10785,148304,25
329000,128451,11412,11011,150874,25
329000,158393,15625,11262,185280,28
329000,165381,10944,12266,188591,28
329500,132604,11149,10972,154725,25
329500,137718,17657,23907,179282,25
329500,155343,11979,11183,178505,28
329500,131076,10808,11249,153133,28
329500,126274,13050,11737,151061,22
330000,138702,15537,11164,165403,22
330000,135496,11392,11670,158558,26
330000,132289,11618,11452,155359,26
330000,132711,11174,10927,154812,23
330000,127687,19433,15444,162564,23
330500,127871,10989,10925,149785,23
330500,137845,11034,11266,160145,23
330500,136480,11025,11489,158994,23
330500,127716,11286,10942,149944,25
330500,130529,11003,11163,152695,25
331000,129675,10824,10918,151417,28
331000,128157,11084,11090,150331,28
331000,125939,11153,11621,148713,29
331000,127855,12510,11276,151641,29
331000,128062,11091,10922,150075,24
331500,126813,11119,21332,159264,24
331500,129489,10970,11637,152096,24
331500,131931,10891,11358,154180,27
331500,130972,11234,11609,153815,27
331500,127435,11132,11128,149695,25
332000,130819,10954,11264,153037,25
332000,126769,10921,11306,148996,25
332000,130562,11204,10938,152704,25
332000,128425,10889,10955,150269,29
332000,128467,11186,11103,150756,29
332500,130222,11153,11104,152479,25
332500,127904,10916,11403,150223,25
332500,127464,10841,10907,149212,31
332500,138853,11249,11533,161635,31
332500,147177,11773,11248,170198,28
333000,158939,12660,12281,183880,28
333000,141742,10877,10941,163560,32
333000,126531,11250,11311,149092,32
333000,123880,12248,13748,149876,23
333000,128086,13174,12408,153668,23
333500,129930,11043,11250,152223,23
333500,126936,10999,11089,149024,21
333500,130028,11063,11429,152520,21
333500,129766,11496,12017,153279,25
333500,139996,11040,11147,162183,25
334000,128418,10869,11049,150336,32
334000,131160,11406,11109,153675,32
334000,128467,11887,11128,151482,28
334000,127913,10979,11592,150484,28
334000,139292,11156,22050,172498,28
334500,134347,11734,11903,157984,28
334500,129344,13647,13121,156112,28
334500,132757,11138,14257,158152,28
334500,170961,11443,10993,193397,21
334500,128056,12289,10993,151338,21
335000,131611,11294,11266,154171,27
335000,141941,11036,11002,163979,27
335000,183212,14144,14925,212281,22
335000,156651,10965,11032,178648,22
335000,148321,10754,10861,169936,21
335500,132301,12567,11506,156374,21
335500,128659,11181,14416,154256,21
335500,133357,11228,10947,155532,25
335500,132133,12319,21609,166061,25
335500,173942,14402,18241,206585,28
336000,197170,20242,16322,233734,25
336000,177362,17935,17977,213274,25
336000,199148,18082,17484,234714,26
336000,174216,10888,11756,196860,21
336000,128972,10916,12421,152309,21
336500,135188,11064,11067,157319,21
336500,135343,11233,11424,158000,28
336500,167892,10967,12122,190981,28
336500,170381,20176,20687,211244,26
336500,127005,11368,11020,149393,27
337000,131444,11120,11040,153604,27
337000,130970,12105,12611,155686,29
337000,164382,11290,11827,187499,29
337000,144635,11168,11210,167013,28
337000,144834,11258,11287,167379,28
337500,140593,11074,11115,162782,29
337500,138341,11404,12135,161880,29
337500,131420,11201,11022,153643,28
337500,161902,18931,17542,198375,28
337500,131139,11217,12158,154514,21
338000,130268,11029,11027,152324,21
338000,130421,10945,11176,152542,28
338000,129281,11206,12054,152541,28
338000,132295,11386,11533,155214,28
338000,129453,11125,11373,151951,28
338500,132750,12211,11636,156597,23
338500,128893,12149,11782,152824,23
338500,129155,11702,11230,152087,23
338500,130550,11414,11246,153210,27
338500,131326,11579,11119,154024,27
339000,130207,11098,11113,152418,23
339000,131615,11062,11104,153781,23
339000,142012,15164,11833,169009,25
339000,131212,12443,11379,155034,25
339000,135924,11029,11722,158675,23
339500,128891,11156,11424,151471,23
339500,129582,11475,11196,152253,23
339500,131860,11242,11490,154592,28
339500,128783,11097,11162,151042,28
339500,140398,11425,11933,163756,36
340000,130877,11212,11176,153265,37
340000,133910,11384,12331,157625,25
340000,134651,11126,11181,156958,25
340000,142293,12142,12041,166476,28
340000,131899,19969,17030,168898,28
340500,158085,11650,11862,181597,28
340500,129254,11159,11451,151864,28
340500,132320,11454,11257,155031,25
340500,134129,11554,11186,156869,25
340500,130039,11141,11201,152381,31
341000,129430,11878,11492,152800,31
341000,131076,11836,11261,154173,20
341000,149592,11783,13795,175170,20
341000,177429,20493,21199,219121,24
341000,188047,11163,11409,210619,24
341500,135284,14212,13995,163491,22
341500,163391,14245,21607,199243,22
341500,129068,11786,11284,152138,24
341500,132267,11635,11333,155235,24
341500,137468,17996,16717,172181,26
342000,130095,11122,11571,152788,26
342000,135610,11042,11722,158374,20
342000,135464,11159,12242,158865,20
342000,131136,11242,11718,154096,32
342000,132537,11198,11226,154961,32
342500,135012,11409,11329,157750,28
342500,164361,11157,11230,186748,28
342500,138763,11768,12536,163067,31
342500,131697,11184,11361,154242,31
342500,146312,11386,11500,169198,31
343000,129754,11851,11571,153176,21
343000,131184,11272,11303,153759,21
343000,181491,16659,16688,214838,21
343000,132792,12749,11197,156738,24
343000,131494,11138,11838,154470,22
343500,129505,11163,11196,151864,22
343500,130830,12200,11932,154962,22
343500,135566,11452,11672,158690,31
343500,134901,11592,11810,158303,31
343500,190311,17878,16409,224598,28
344000,177135,21521,17327,215983,27
344000,140060,19832,17200,177092,27
344000,139100,11135,11360,161595,22
344000,161827,11364,11417,184608,22
344000,131802,11573,11568,154943,34
344500,134434,11273,11325,157032,24
344500,168268,11202,11803,191273,24
344500,132193,11489,11510,155192,24
344500,158827,11538,12377,182742,27
344500,132381,14717,13414,160512,27
345000,132930,11858,11614,156402,19
345000,132048,11841,11303,155192,19
345000,132058,11829,11784,155671,25
345000,130470,11762,11530,153762,25
345000,132445,11508,15107,159060,23
345500,139084,11323,11262,161669,23
345500,136181,11239,11288,158708,32
345500,138716,15341,12770,166827,32
345500,187787,14362,14543,216692,31
345500,144401,11238,11270,166909,31
346000,130746,11231,18005,159982,28
346000,138150,12977,12993,164120,28
346000,136259,11446,12221,159926,34
346000,139517,12158,12602,164277,34
346000,135479,11441,11745,158665,26
346500,136835,12049,11806,160690,22
346500,134483,11307,11357,157147,22
346500,133445,11315,11603,156363,22
346500,135962,11268,12801,160031,24
346500,139385,11243,11264,161892,24
347000,133760,11369,11831,156960,30
347000,133574,11513,11588,156675,30
347000,133085,12084,11566,156735,22
347000,134348,11453,12072,157873,22
347000,133075,11598,11881,156554,26
347500,139440,11787,11653,162880,26
347500,133893,11968,18359,164220,30
347500,154600,14110,14176,182886,30
347500,167977,12467,11585,192029,30
347500,133460,17886,14939,166285,30
348000,139010,11675,11368,162053,31
348000,132671,11295,11321,155287,31
348000,138697,11885,11401,161983,25
348000,133859,12304,11673,157836,25
348000,134754,11495,11486,157735,25
348500,142581,11845,12582,167008,25
348500,135128,11405,11400,157933,26
348500,134272,11388,12259,157919,26
348500,135276,11371,11423,158070,29
348500,136820,11384,11429,159633,29
349000,133171,11340,11698,156209,23
349000,134251,11318,11523,157092,23
349000,152063,11608,11718,175389,28
349000,135192,12411,11400,159003,28
349000,132696,11239,11772,155707,36
349500,134200,12275,11377,157852,36
349500,132256,11480,12218,155954,29
349500,133801,11739,11779,157319,29
349500,137141,11435,11506,160082,30
349500,147128,12090,11717,170935,30
350000,134355,11974,17467,163796,24
350000,153777,12547,11572,177896,24
350000,170823,11383,12219,194425,27
350000,149704,11374,11638,172716,30
350000,179566,23924,23006,226496,30
350500,138142,12464,11494,162100,21
350500,135684,12129,12529,160342,21
350500,142028,11471,12445,165944,29
350500,137366,11690,12056,161112,29
350500,146367,12780,18140,177287,28
351000,150556,11921,11731,174208,28
351000,139165,11362,11635,162162,28
351000,143469,11778,11727,166974,28
351000,139109,14595,12893,166597,25
351000,141292,12341,11506,165139,25
351500,141881,14331,12258,168470,26
351500,135267,11903,11466,158636,26
351500,140709,11333,11828,163870,29
351500,133814,11471,11957,157242,29
351500,135638,11393,11445,158476,26
352000,138045,12546,13046,163637,27
352000,141032,13009,12689,166730,30
352000,152899,11444,11432,175775,25
352000,145920,11935,12083,169938,25
352000,137125,11513,11542,160180,29
352500,140600,11998,11576,164174,29
352500,136695,12424,14286,163405,22
352500,160969,12737,11780,185486,22
352500,140399,12508,11832,164739,27
352500,136336,14256,11595,162187,27
353000,135700,11521,11558,158779,30
353000,136345,12789,12029,161163,30
353000,135095,11500,13088,159683,31
353000,135791,12211,11798,159800,31
353000,135086,11513,11608,158207,23
353500,142427,12416,12527,167370,23
353500,134835,12132,11934,158901,31
353500,178473,11465,11519,201457,31
353500,161849,12360,11594,185803,26
353500,144207,12670,12513,169390,26
354000,135084,11558,11665,158307,23
354000,137000,11587,12288,160875,23
354000,142416,11526,11602,165544,26
354000,144384,12118,11655,168157,26
354000,136935,12072,12204,161211,30
354500,137125,12166,11906,161197,30
354500,142422,12300,11794,166516,30
354500,142777,11557,12322,166656,30
354500,138396,11727,11854,161977,27
354500,135921,11806,11622,159349,27
355000,140341,12018,12021,164380,30
355000,136042,12065,11691,159798,30
355000,138848,11559,11613,162020,26
355000,136560,11750,11610,159920,26
355000,152960,12434,11643,177037,21
355500,139027,12444,12104,163575,21
355500,136425,11631,11899,159955,22
355500,140744,12166,13157,166067,22
355500,137807,12019,11790,161616,24
355500,136551,11600,11757,159908,24
356000,139896,11591,12232,163719,24
356000,137559,12099,11993,161651,20
356000,137780,12443,11674,161897,20
356000,140326,12262,12127,164715,21
356000,159687,14703,12719,187109,21
356500,183524,12378,12520,208422,27
356500,143654,11902,11953,167509,27
356500,143874,12260,13689,169823,29
356500,144552,11672,12415,168639,29
356500,150843,12126,12099,175068,28
357000,137996,13733,12880,164609,28
357000,136770,11603,11679,160052,31
357000,138964,12353,13144,164461,20
357000,138439,12165,12233,162837,20
357000,138180,12159,11762,162101,20
357500,137773,11959,11767,161499,25
357500,139643,11756,11843,163242,25
357500,141437,12481,11990,165908,25
357500,143401,11933,12171,167505,25
357500,140362,11720,11992,164074,26
358000,141174,12340,12223,165737,26
358000,144516,11822,12734,169072,29
358000,141486,11841,12615,165942,29
358000,140408,11721,12707,164836,27
358000,139836,12125,12110,164071,27
358500,161504,12322,12697,186523,30
358500,149521,12681,12765,174967,30
358500,138555,12740,12981,164276,23
358500,151562,12775,15880,180217,23
358500,138258,11823,11755,161836,22
359000,140198,12104,11799,164101,22
359000,139492,11691,11746,162929,31
359000,139711,12029,11745,163485,31
359000,140712,11764,12026,164502,32
359000,141436,11676,11854,164966,32
359500,137704,12487,12061,162252,29
359500,138165,11688,11964,161817,29
359500,145665,11729,11768,169162,25
359500,137189,12052,11870,161111,25
359500,139190,11769,11828,162787,25
360000,140869,11881,12378,165128,25
360000,141575,14838,14804,171217,20
360000,166332,11838,11718,189888,20
360000,144803,16827,17830,179460,23
360000,145579,13357,13208,172144,23
360500,139417,12530,11886,163833,25
360500,144899,14329,15281,174509,25
360500,140045,12924,13460,166429,24
360500,145556,12010,11966,169532,24
360500,142719,11978,12846,167543,33
361000,141799,12267,12228,166294,33
361000,234362,16416,17696,268474,27
361000,161044,18959,17354,197357,22
361000,240494,20101,23292,283887,22
361000,226533,20903,19829,267265,20
361500,151536,11895,11920,175351,25
361500,218436,17946,17981,254363,25
361500,209343,12339,12071,233753,22
361500,149503,11756,12001,173260,22
361500,203770,12389,12852,229011,27
362000,142952,11706,11798,166456,27
362000,153927,11718,11912,177557,31
362000,144767,11926,11782,168475,22
362000,163193,22301,24492,209986,22
362000,141048,11706,11820,164574,25
362500,170610,19343,21072,211025,25
362500,147464,11739,11899,171102,26
362500,155752,11707,11834,179293,26
362500,169074,11891,12275,193240,26
362500,151996,11738,11838,175572,26
363000,142171,12773,14270,169214,25
363000,144630,12501,12291,169422,25
363000,155832,12532,12325,180689,30
363000,142136,12394,12129,166659,30
363000,141136,12074,12084,165294,23
363500,147834,12367,12425,172626,23
363500,144467,12616,11957,169040,17
363500,143633,12234,15041,170908,17
363500,144366,12527,12325,169218,23
363500,141979,11929,11908,165816,23
364000,140088,12303,12243,164634,28
364000,150536,11750,12218,174504,28
364000,148232,15768,15596,179596,25
364000,142744,11771,12558,167073,25
364000,157905,14637,13415,185957,28
364500,148295,12149,11995,172439,28
364500,153614,16187,14156,183957,26
364500,144797,12789,12194,169780,26
364500,143196,11911,12292,167399,23
364500,142602,11853,12346,166801,23
365000,142381,11851,11947,166179,26
365000,141271,11952,12194,165417,26
365000,145014,11839,11922,168775,32
365000,140175,12081,12483,164739,32
365000,141650,11868,11932,165450,27
365500,142417,12617,12061,167095,22
365500,145517,23715,15252,184484,22
365500,147646,13797,12038,173481,22
365500,142068,11981,12207,166256,27
365500,147251,12537,12121,171909,27
366000,145562,12597,12240,170399,27
366000,155697,12165,14001,181863,27
366000,144606,11990,12035,168631,32
366000,148930,11874,12763,173567,25
366000,147948,12207,13402,173557,25
366500,144126,12275,13234,169635,28
366500,143476,12562,12243,168281,28
366500,142299,12367,12736,167402,29
366500,142104,11958,12451,166513,29
366500,143880,12379,12949,169208,29
367000,142217,11997,12759,166973,29
367000,141181,12260,12568,166009,25
367000,156537,12326,12033,180896,25
367000,144312,12221,12146,168679,22
367000,143474,12247,12296,168017,22
367500,151055,14900,12876,178831,20
367500,145010,12293,12181,169484,20
367500,148760,12294,16364,177418,36
367500,145489,11813,12217,169519,36
367500,165563,13025,13093,191681,24
368000,165680,16488,13875,196043,26
368000,159161,12499,12121,183781,26
368000,144566,12822,13281,170669,25
368000,154581,11892,12003,178476,25
368000,143483,12104,12028,167615,25
368500,148163,12360,12666,173189,25
368500,157898,16733,12100,186731,22
368500,172260,12673,13555,198488,22
368500,144553,12123,12259,168935,22
368500,145188,12372,12588,170148,22
369000,145501,12003,12200,169704,28
369000,145795,12252,12210,170257,28
369000,143972,15887,12839,172698,22
369000,149261,12638,12216,174115,22
369000,142393,11886,12408,166687,22
369500,153612,12471,12021,178104,22
369500,152414,14309,15765,182488,26
369500,151217,11930,12059,175206,26
369500,144392,12392,12049,168833,26
369500,145008,12578,11971,169557,26
370000,143217,12037,12175,167429,26
370000,143307,12011,12621,167939,26
370000,142835,11991,12079,166905,27
370000,142052,12612,12181,166845,27
370000,145967,12096,12501,170564,25
370500,144769,14712,12677,172158,25
370500,163077,11951,12113,187141,31
370500,143060,12005,12097,167162,31
370500,144440,12047,12063,168550,29
370500,141936,12000,12495,166431,29
371000,141563,12179,12056,165798,31
371000,141668,12176,12904,166748,31
371000,145763,12041,12445,170249,27
371000,146447,12211,12193,170851,27
371000,141407,12019,12138,165564,27
371500,142040,12033,12619,166692,30
371500,143556,12503,12129,168188,30
371500,143573,12167,12146,167886,22
371500,143624,12614,12220,168458,22
371500,148722,12180,12103,173005,21
372000,142754,12047,12065,166866,21
372000,144286,12523,12173,168982,31
372000,145576,12351,12594,170521,31
372000,143716,12083,12459,168258,24
372000,144125,12127,12993,169245,24
372500,142561,12596,12286,167443,28
372500,142037,12151,12134,166322,28
372500,142233,12401,12194,166828,20
372500,141538,12142,12303,165983,20
372500,143865,12118,12414,168397,25
373000,144136,12104,12481,168721,25
373000,141289,12654,12164,166107,25
373000,144930,12129,12496,169555,25
373000,169938,12505,12144,194587,25
373000,144856,12511,12179,169546,25
373500,142082,12627,12342,167051,27
373500,144986,12441,12193,169620,27
373500,148310,12278,12211,172799,27
373500,144558,12357,12177,169092,27
373500,144786,12167,12309,169262,33
374000,144760,12434,12272,169466,33
374000,151303,12435,12743,176481,25
374000,144192,12860,14070,171122,25
374000,144682,12104,12499,169285,27
374000,144005,12096,12432,168533,27
374500,153146,12161,12203,177510,23
374500,146552,12181,12194,170927,23
374500,143326,13231,12339,168896,31
374500,144113,12551,12196,168860,31
374500,148988,12155,13266,174409,25
375000,145046,13013,12280,170339,21
375000,147828,12836,12210,172874,21
375000,165329,12172,12387,189888,21
375000,145023,12173,12969,170165,29
375000,145036,12137,12239,169412,29
375500,146604,12145,12356,171105,24
375500,145649,12146,12577,170372,24
375500,146594,12334,12544,171472,19
375500,148323,12735,12271,173329,19
375500,146232,12149,16639,175020,22
376000,146833,12473,12645,171951,22
376000,142900,12855,12254,168009,27
376000,146076,12597,12896,171569,27
376000,144801,12398,12954,170153,29
376000,143525,12193,12240,167958,29
376500,147049,12641,12694,172384,28
376500,145807,12548,12988,171343,28
376500,146284,12199,12845,171328,26
376500,145918,12646,12312,170876,34
376500,145454,12235,12616,170305,34
377000,148627,12240,12277,173144,22
377000,145124,12371,12799,170294,22
377000,159789,12207,12708,184704,25
377000,144972,12216,12437,169625,25
377000,143201,12600,12622,168423,15
377500,143257,12101,12179,167537,15
377500,145568,12083,12292,169943,15
377500,153665,14544,14371,182580,29
377500,144829,12219,12163,169211,29
377500,146281,12269,12345,170895,32
378000,145889,17973,20856,184718,32
378000,147345,12335,12780,172460,27
378000,143641,15777,23512,182930,27
378000,149214,13217,13056,175487,27
378000,150517,12325,12315,175157,25
378500,147309,12299,12410,172018,25
378500,144119,12228,12731,169078,21
378500,147367,12770,12605,172742,21
378500,145207,12370,12899,170476,26
378500,147514,12593,12425,172532,26
379000,145954,12386,12504,170844,25
379000,147156,13536,12870,173562,25
379000,147154,12640,12404,172198,26
379000,146586,12586,12464,171636,26
379000,145610,12252,12343,170205,36
379500,147272,12306,12346,171924,36
379500,145656,12558,12398,170612,26
379500,147536,12283,12341,172160,26
379500,149675,12672,12394,174741,27
379500,148638,12300,12687,173625,27
380000,145399,12332,12360,170091,24
380000,148017,12316,12399,172732,23
380000,145848,12315,12443,170606,23
380000,148216,13333,12557,174106,27
380000,150543,12635,12417,175595,27
380500,146117,12326,12463,170906,29
380500,145572,12637,12402,170611,29
380500,149258,12334,12723,174315,30
380500,146803,12611,12470,171884,30
380500,146176,12296,12373,170845,26
381000,146646,12369,12458,171473,26
381000,153107,12552,12443,178102,27
381000,147535,12534,12403,172472,27
381000,148227,14382,12813,175422,24
381000,149092,12355,12859,174306,24
381500,148461,12754,12546,173761,24
381500,146090,13386,12776,172252,24
381500,149220,12684,12653,174557,26
381500,147297,12385,12415,172097,26
381500,147654,16058,13063,176775,24
382000,146507,12669,12427,171603,24
382000,146186,12757,12463,171406,25
382000,146210,12395,12585,171190,25
382000,150657,12797,12414,175868,24
382000,148404,12359,13244,174007,24
382500,147777,12443,12770,172990,26
382500,146635,12730,12467,171832,26
382500,149240,12356,12449,174045,29
382500,151708,12719,12426,176853,29
382500,146426,12810,12546,171782,18
383000,146187,12610,12661,171458,18
383000,149687,12399,12488,174574,32
383000,149433,12391,12469,174293,32
383000,146782,12485,12468,171735,27
383000,148213,12830,12639,173682,27
383500,145346,12275,12337,169958,27
383500,150807,12725,12714,176246,25
383500,148855,12645,12901,174401,25
383500,150159,12413,12553,175125,21
383500,147198,12544,12885,172627,21
384000,161110,12643,12539,186292,26
384000,151148,12415,12508,176071,26
384000,177891,12518,13207,203616,21
384000,152368,12260,12715,177343,21
384000,160911,15451,13663,190025,32
384500,149887,12802,12518,175207,32
384500,150162,12787,12746,175695,27
384500,163744,12737,12726,189207,27
384500,149616,12453,12811,174880,24
384500,147044,12444,12773,172261,24
385000,147152,12446,12558,172156,27
385000,146925,12432,12563,171920,27
385000,170031,12633,12573,195237,33
385000,148785,12464,12510,173759,25
385000,147398,12414,13667,173479,25
385500,147456,12731,12560,172747,30
385500,151462,12545,13032,177039,30
385500,148181,12466,12559,173206,25
385500,148453,12599,12566,173618,25
385500,148381,12884,12651,173916,20
386000,151515,12608,12614,176737,20
386000,148430,12480,12935,173845,23
386000,151630,12867,12741,177238,23
386000,147357,12471,12579,172407,27
386000,148629,12806,12542,173977,27
386500,148229,12540,13228,173997,23
386500,151299,12552,12549,176400,23
386500,150554,12483,12584,175621,25
386500,148860,13154,12585,174599,25
386500,148293,12605,12578,173476,34
387000,148302,12521,12647,173470,34
387000,149986,12473,12600,175059,27
387000,148105,12393,13380,173878,27
387000,149124,12392,12507,174023,25
387000,152165,12387,12478,177030,21
387500,152282,12418,12510,177210,21
387500,150946,12977,16876,180799,21
387500,151056,13996,13199,178251,33
387500,148633,12528,12603,173764,26
387500,150582,12534,13560,176676,26
388000,150384,13121,12961,176466,25
388000,150733,12739,12650,176122,25
388000,148975,12520,12654,174149,18
388000,149215,12921,12660,174796,18
388000,148637,12579,12574,173790,18
388500,151494,12548,13010,177052,23
388500,150597,12650,13417,176664,23
388500,151920,12776,12731,177427,29
388500,150153,12659,13105,175917,29
388500,150013,12631,12793,175437,24
389000,149807,12599,13067,175473,31
389000,152264,12681,12784,177729,31
389000,148671,12578,12646,173895,20
389000,150274,12658,13103,176035,20
389000,148713,12869,12961,174543,21
389500,150648,12605,12805,176058,21
389500,149118,12991,12517,174626,28
389500,176932,12713,12696,202341,28
389500,148920,12468,12540,173928,32
389500,152008,12670,12983,177661,32
390000,148696,12482,15944,177122,26
390000,166615,17294,16474,200383,26
390000,183062,15643,15629,214334,27
390000,147891,12625,12756,173272,29
390000,147502,13053,12720,173275,29
390500,150537,12819,13010,176366,33
390500,152416,12575,12866,177857,33
390500,160772,20611,16427,197810,28
390500,151002,12691,13209,176902,24
390500,150190,12524,12660,175374,24
391000,153410,12657,12699,178766,30
391000,153931,12619,12763,179313,30
391000,150604,12756,12840,176200,25
391000,151078,12961,13408,177447,25
391000,151412,12813,12911,177136,22
391500,157144,12810,12735,182689,22
391500,152050,12654,12844,177548,29
391500,151584,12644,28685,192913,29
391500,151144,12671,12773,176588,29
391500,151426,12686,13176,177288,29
392000,157032,12716,12920,182668,35
392000,150353,12684,12727,175764,28
392000,153997,14366,13173,181536,28
392000,153285,12665,12725,178675,28
392000,152248,12655,12762,177665,28
392500,153736,12687,12736,179159,24
392500,151034,12714,13654,177402,24
392500,151306,12700,12770,176776,27
392500,152184,12879,12891,177954,27
392500,154382,13037,13633,181052,26
393000,149936,12711,12772,175419,25
393000,151589,13051,12803,177443,25
393000,156951,12657,12916,182524,29
393000,153851,12709,12963,179523,29
393000,154033,13051,12967,180051,25
393500,160067,13121,12802,185990,25
393500,152627,12943,13208,178778,24
393500,152039,12719,12936,177694,24
393500,150040,12736,13257,176033,27
393500,153421,13097,13045,179563,27
394000,153352,12777,13965,180094,27
394000,152062,13011,12838,177911,27
394000,152539,13464,14325,180328,26
394000,154846,12731,12797,180374,29
394000,160145,12745,13205,186095,29
394500,153193,13102,12972,179267,24
394500,152415,13320,12988,178723,24
394500,152707,12817,13323,178847,28
394500,152641,12737,12791,178169,28
394500,153382,12717,12872,178971,33
395000,153114,12950,12978,179042,33
395000,154551,13152,14032,181735,20
395000,153413,13362,12866,179641,23
395000,151401,12748,12830,176979,23
395000,151423,12754,12852,177029,27
395500,152706,12927,13776,179409,27
395500,154955,13631,12879,181465,27
395500,154876,14868,19577,189321,27
395500,153204,12944,12832,178980,24
395500,156809,13290,15698,185797,24
396000,153648,12688,12780,179116,30
396000,152947,12888,12992,178827,30
396000,156431,12784,12915,182130,24
396000,156557,13019,13003,182579,24
396000,154617,13022,12865,180504,29
396500,151721,13012,12878,177611,20
396500,152296,12837,12984,178117,20
396500,192867,12948,13400,219215,20
396500,153769,12961,12893,179623,24
396500,152542,12813,13073,178428,24
397000,154697,12814,12906,180417,22
397000,154109,12881,13107,180097,27
397000,168750,13763,13006,195519,27
397000,152909,12949,13087,178945,24
397000,152764,12950,12883,178597,24
397500,154085,12967,15736,182788,29
397500,155772,13109,13236,182117,29
397500,168741,17689,15955,202385,26
397500,153310,13018,13164,179492,26
397500,159601,12862,12934,185397,32
398000,154590,12899,12945,180434,26
398000,154547,12962,13430,180939,26
398000,155361,13062,13482,181905,22
398000,160096,13003,13454,186553,22
398000,155222,13233,13221,181676,26
398500,153395,12860,12940,179195,26
398500,154054,12851,13132,180037,27
398500,154539,13528,12969,181036,27
398500,155710,13203,13650,182563,27
398500,155510,13087,12954,181551,27
399000,178101,13142,12998,204241,28
399000,154133,13559,15054,182746,28
399000,156812,13017,13486,183315,29
399000,155315,12882,12984,181181,24
399000,156893,12941,13378,183212,24
399500,155361,14717,13148,183226,22
399500,156302,12926,12988,182216,22
399500,153319,12789,12834,178942,25
399500,155802,12886,12978,181666,25
399500,155892,13265,12997,182154,20
400000,156810,13467,13007,183284,20
400000,151653,13959,12945,178557,19
400000,173053,12840,14318,200211,19
400000,163455,13709,13410,190574,24
400000,155547,13146,12993,181686,24
400500,154357,13089,13027,180473,24
400500,158564,13142,13029,184735,24
400500,156825,13229,13310,183364,26
400500,157844,12910,13387,184141,26
400500,157481,12906,13147,183534,29
401000,157282,13539,13030,183851,29
401000,163849,13158,13266,190273,24
401000,157839,12989,13148,183976,24
401000,156424,13153,13894,183471,27
401000,153791,12940,13044,179775,33
401500,154472,13374,13031,180877,33
401500,159084,16008,16143,191235,25
401500,170612,12760,13207,196579,25
401500,154617,12765,13241,180623,25
401500,152034,12925,12918,177877,25
402000,156639,13131,13270,183040,25
402000,156707,15427,13185,185319,19
402000,159023,12943,13074,185040,19
402000,156309,12959,13058,182326,19
402000,157346,13014,13079,183439,26
402500,155456,13017,13144,181617,26
402500,156800,13955,13206,183961,29
402500,157655,13694,13380,184729,24
402500,162587,13377,13392,189356,24
402500,156470,13207,13228,182905,28
403000,157013,13002,13083,183098,28
403000,155443,13291,13664,182398,25
403000,155930,13018,13316,182264,25
403000,186002,13002,13087,212091,25
403000,159734,13728,13382,186844,25
403500,156780,13247,13190,183217,29
403500,154733,12997,13091,180821,33
403500,156479,13335,14653,184467,33
403500,156449,15588,13145,185182,30
403500,155930,13524,13138,182592,30
404000,157547,13020,13765,184332,27
404000,159353,13145,13600,186098,28
404000,157139,13651,13321,184111,28
404000,157988,13495,13944,185427,21
404000,161377,13629,13124,188130,21
404500,157071,13028,14060,184159,26
404500,157651,13693,13673,185017,26
404500,156340,13401,13307,183048,21
404500,157825,14367,13131,185323,21
404500,158978,13110,13155,185243,25
405000,156476,13447,13168,183091,25
405000,158590,13103,13316,185009,24
405000,171810,13144,13203,198157,24
405000,159061,13151,13493,185705,28
405000,155454,13015,13057,181526,23
405500,157836,13470,13253,184559,23
405500,156364,13249,13148,182761,26
405500,158345,13264,13345,184954,26
405500,159164,13105,13331,185600,27
405500,158539,13152,13520,185211,27
406000,157463,13413,13808,184684,25
406000,178926,13421,13425,205772,25
406000,157050,13151,13165,183366,23
406000,158134,13108,13181,184423,23
406000,156480,13649,14162,184291,31
406500,162102,14649,13345,190096,19
406500,158432,13980,13232,185644,19
406500,158218,13132,13438,184788,25
406500,161735,13334,13085,188154,25
406500,172704,13949,14641,201294,26
407000,162039,13152,13203,188394,26
407000,159680,13610,14173,187463,36
407000,158798,13556,14794,187148,36
407000,171050,14328,19559,204937,23
407000,154626,12971,14134,181731,23
407500,156612,13189,13256,183057,23
407500,158542,13305,13218,185065,29
407500,157776,13438,13250,184464,29
407500,156269,13131,13191,182591,28
407500,157341,13752,13487,184580,31
408000,157284,13187,13422,183893,31
408000,158922,13365,15295,187582,25
408000,158079,13648,13861,185588,25
408000,158264,14895,13501,186660,24
408000,158068,13664,13410,185142,24
408500,158778,13705,13358,185841,24
408500,160420,13238,13559,187217,24
408500,160160,16993,13297,190450,29
408500,160045,13155,13265,186465,28
408500,159190,13181,13286,185657,28
409000,157606,13174,13905,184685,21
409000,159349,13309,13332,185990,21
409000,160291,13206,13864,187361,20
409000,159149,13342,13552,186043,20
409000,158944,14169,13532,186645,27
409500,158256,13304,13322,184882,27
409500,159648,13494,13277,186419,23
409500,159419,14144,13301,186864,23
409500,161387,13412,13396,188195,26
409500,161220,13190,13563,187973,26
410000,159816,13528,13409,186753,25
410000,159437,13346,13311,186094,25
410000,159271,13548,13413,186232,31
410000,180206,13141,13154,206501,31
410000,164848,15190,14266,194304,31
410500,158043,13134,13153,184330,24
410500,160584,13485,13310,187379,24
410500,160097,13706,13288,187091,26
410500,158341,13252,13526,185119,21
410500,158820,13357,14642,186819,21
411000,158410,13266,13529,185205,29
411000,158527,13705,13466,185698,29
411000,159603,13278,13317,186198,22
411000,158439,13713,13299,185451,22
411000,159261,13274,13400,185935,15
411500,159649,13968,14271,187888,15
411500,156663,13102,16112,185877,24
411500,169847,13386,14076,197309,24
411500,159993,13993,13381,187367,27
411500,162887,13259,13534,189680,27
412000,159721,14131,13633,187485,32
412000,160130,13293,13362,186785,32
412000,167055,13520,13680,194255,21
412000,159396,13347,13712,186455,33
412000,160095,13903,13654,187652,33
412500,161327,13293,13690,188310,30
412500,162262,13321,13404,188987,23
412500,160155,13326,13692,187173,23
412500,162492,13990,13436,189918,21
412500,163958,13645,13456,191059,21
413000,164674,13306,13545,191525,27
413000,161147,13512,13766,188425,27
413000,160954,13308,13252,187514,32
413000,160890,13210,13251,187351,32
413000,160432,13163,13236,186831,24
413500,159723,13201,13296,186220,28
413500,160393,13148,13287,186828,28
413500,169365,15436,13363,198164,27
413500,161534,13208,13420,188162,27
413500,160541,13396,13500,187437,21
414000,161005,13878,14106,188989,21
414000,165372,17398,13595,196365,21
414000,160568,13355,13588,187511,21
414000,161393,13327,13431,188151,20
414000,161327,13684,13601,188612,20
414500,159959,13365,13433,186757,26
414500,159937,13398,13441,186776,22
414500,160256,13436,13439,187131,22
414500,160533,13455,13449,187437,27
414500,161596,14142,14497,190235,27
415000,163152,13607,13474,190233,27
415000,159942,13398,13698,187038,27
415000,162034,13413,13985,189432,30
415000,162557,13429,13471,189457,30
415000,160238,14079,13726,188043,28
415500,179993,18962,15390,214345,26
415500,162436,13553,13467,189456,26
415500,161455,13712,13469,188636,25
415500,162670,13464,13787,189921,25
415500,161737,14463,13660,189860,25
416000,164924,13729,14016,192669,25
416000,160563,13399,14830,188792,22
416000,160668,13781,13515,187964,28
416000,161071,13420,13500,187991,28
416000,165004,13440,13505,191949,26
416500,161954,13630,13492,189076,26
416500,163806,13541,13491,190838,26
416500,161435,13499,13595,188529,26
416500,163965,13448,13512,190925,21
416500,163463,13519,13539,190521,21
417000,162700,13435,13503,189638,21
417000,163339,13482,13561,190382,21
417000,170229,13525,13712,197466,19
417000,164877,13401,13549,191827,19
417000,163835,13921,13541,191297,26
417500,183644,13695,13534,210873,29
417500,161878,13474,13530,188882,29
417500,163157,13557,13661,190375,25
417500,163421,13472,13683,190576,25
417500,161837,13455,13517,188809,26
418000,161097,13701,13824,188622,26
418000,165450,14168,13544,193162,24
418000,161995,13561,14048,189604,23
418000,171212,13798,13950,198960,23
418000,161611,13875,13751,189237,25
418500,163266,13572,14164,191002,25
418500,168330,13294,13391,195015,26
418500,166823,13598,13748,194169,26
418500,172280,14016,14173,200469,25
418500,164275,13879,13977,192131,26
419000,162778,13781,14140,190699,26
419000,170229,13574,13775,197578,21
419000,166514,13806,13610,193930,21
419000,163234,13502,13692,190428,25
419000,162841,13492,14069,190402,25
419500,163742,13764,13861,191367,27
419500,162531,13505,13628,189664,27
419500,164609,13519,13570,191698,30
419500,161494,13517,13589,188600,23
419500,164116,13528,13710,191354,23
420000,171028,13587,13636,198251,22
420000,162478,13505,13604,189587,22
420000,163330,13786,13680,190796,28
420000,161384,13787,13616,188787,28
420000,163530,13691,14004,191225,24
420500,162361,14290,13856,190507,24
420500,167377,16156,13733,197266,28
420500,164614,13571,13775,191960,24
420500,167024,14516,14255,195795,24
420500,166846,13401,13413,193660,27
421000,179904,13534,14463,207901,27
421000,164763,13589,13687,192039,22
421000,166730,13740,13647,194117,22
421000,163567,14261,13807,191635,29
421000,165324,13552,13637,192513,27
421500,168623,13673,14205,196501,27
421500,163590,13579,14119,191288,33
421500,165810,13605,13742,193157,33
421500,162844,13868,13651,190363,29
421500,164672,13596,14569,192837,28
422000,163447,13788,13704,190939,28
422000,163034,13738,13639,190411,24
422000,163460,13777,13968,191205,24
422000,163387,13896,13994,191277,24
422000,168390,14560,16162,199112,33
422500,162708,13593,14696,190997,33
422500,164999,13612,14226,192837,28
422500,164877,14079,14189,193145,28
422500,166084,13904,13700,193688,24
422500,164779,13552,14327,192658,24
423000,167112,14248,13830,195190,24
423000,165155,13648,14725,193528,25
423000,165403,13586,13846,192835,25
423000,162071,13604,14218,189893,22
423000,162613,13843,13934,190390,22
423500,175476,13996,15083,204555,24
423500,164527,14224,13695,192446,24
423500,164205,13614,14076,191895,26
423500,164684,13660,13704,192048,24
423500,171759,13889,13865,199513,24
424000,177723,13466,15655,206844,21
424000,162020,13484,13568,189072,21
424000,166252,13628,17613,197493,26
424000,170564,13460,13576,197600,26
424000,167956,13878,14915,196749,21
424500,179100,13708,13640,206448,21
424500,162837,13883,13639,190359,25
424500,161214,13457,13605,188276,25
424500,165106,14079,16624,195809,25
424500,164827,13691,13976,192494,33
425000,167549,13727,14031,195307,33
425000,166534,13866,13807,194207,26
425000,168851,13757,13763,196371,20
425000,166797,15543,14678,197018,20
425000,167620,13700,13750,195070,24
425500,165336,14070,13813,193219,24
425500,167169,14035,14012,195216,29
425500,166057,13917,13762,193736,29
425500,165574,13732,15422,194728,24
425500,168033,13791,13888,195712,29
426000,166958,14018,13813,194789,29
426000,167568,16062,14286,197916,25
426000,165726,13822,13837,193385,25
426000,164980,13703,14245,192928,25
426000,164693,14035,13774,192502,30
426500,170792,13930,13824,198546,30
426500,166568,13717,13821,194106,25
426500,168855,14152,14314,197321,25
426500,167286,13966,14282,195534,26
426500,166223,13729,13831,193783,29
427000,174143,13733,13993,201869,29
427000,167096,14020,36341,217457,32
427000,166425,14015,13886,194326,32
427000,165256,13765,13933,192954,25
427000,166857,14614,13948,195419,27
427500,170355,13973,13875,198203,27
427500,167038,14132,14067,195237,24
427500,164771,13565,13785,192121,24
427500,166812,13627,13726,194165,23
427500,169726,13577,13684,196987,23
428000,171432,13623,13754,198809,23
428000,168718,13980,13948,196646,24
428000,167202,14021,13856,195079,24
428000,172705,13756,13817,200278,26
428000,170727,13814,14286,198827,26
428500,166036,13825,13865,193726,22
428500,167554,14003,14038,195595,22
428500,171386,13801,13883,199070,28
428500,171583,14204,13904,199691,24
428500,167284,13917,13874,195075,24
429000,166342,13820,13878,194040,19
429000,166938,13807,13851,194596,19
429000,168360,14320,14001,196681,30
429000,192842,16577,18652,228071,30
429000,197168,14763,13659,225590,24
429500,167600,14057,13929,195586,27
429500,168362,13804,13908,196074,27
429500,169541,13596,15558,198695,28
429500,168702,14015,13891,196608,28
429500,168663,14226,14035,196924,29
430000,167473,13834,14606,195913,28
430000,192144,14591,13991,220726,28
430000,166846,13824,13937,194607,26
430000,166510,14124,15049,195683,29
430000,167459,13901,14409,195769,29
430500,171048,13871,14147,199066,26
430500,170172,13700,13806,197678,26
430500,190053,13708,14502,218263,23
430500,177143,13985,14395,205523,21
430500,168385,13838,14049,196272,21
431000,175870,17224,14374,207468,30
431000,168428,14457,15317,198202,30
431000,167471,14993,13964,196428,24
431000,168250,13935,13953,196138,24
431000,173440,14254,14144,201838,28
431500,168588,13911,13976,196475,21
431500,167571,14107,14761,196439,21
431500,170358,13870,13955,198183,25
431500,169731,13920,14052,197703,25
431500,173473,14092,13973,201538,26
432000,169009,13911,13965,196885,26
432000,170802,13885,13993,198680,19
432000,169727,13884,13975,197586,19
432000,170203,14646,14276,199125,19
432000,168474,14099,14055,196628,19
432500,167667,14219,14097,195983,19
432500,167864,13901,14003,195768,19
432500,175322,14134,14226,203682,21
432500,166960,13902,14819,195681,21
432500,171753,13763,14091,199607,24
433000,167814,13925,13888,195627,22
433000,168778,14048,14127,196953,22
433000,165699,14158,13892,193749,21
433000,170962,14113,14028,199103,21
433000,169096,14347,14371,197814,28
433500,173272,14374,14150,201796,28
433500,169393,13991,14035,197419,24
433500,168358,14570,14044,196972,20
433500,169931,13927,14196,198054,20
433500,169528,13946,14649,198123,24
434000,169230,14472,14100,197802,25
434000,168525,13988,14310,196823,24
434000,167842,14171,14208,196221,24
434000,169649,14123,14860,198632,26
434000,169816,14027,14040,197883,26
434500,170972,14103,14052,199127,27
434500,168383,14350,14317,197050,24
434500,170682,13994,14095,198771,24
434500,169877,14068,14637,198582,26
434500,166851,14031,13921,194803,26
435000,170470,13802,15161,199433,28
435000,171678,14208,14241,200127,22
435000,169958,14521,16283,200762,22
435000,170624,14170,14300,199094,26
435000,170057,14468,14207,198732,26
435500,169386,14280,14433,198099,28
435500,169497,13991,14141,197629,28
435500,171520,14196,14282,199998,29
435500,169448,14091,14751,198290,20
435500,169815,13990,14166,197971,20
436000,167800,14871,14497,197168,27
436000,169912,13998,14112,198022,27
436000,169347,14048,14285,197680,25
436000,175211,14094,14428,203733,28
436000,177621,14026,14118,205765,28
436500,169694,14315,14316,198325,26
436500,169149,14415,14102,197666,26
436500,171819,14023,14782,200624,29
436500,168673,14899,14299,197871,19
436500,176428,14835,15043,206306,19
437000,171123,14140,14238,199501,20
437000,172247,14287,14240,200774,20
437000,172286,14054,14208,200548,21
437000,174011,14212,14488,202711,21
437000,169846,14052,14846,198744,20
437500,171404,14457,15116,200977,20
437500,170339,15714,14487,200540,29
437500,169075,14075,14178,197328,29
437500,169645,14140,14218,198003,28
437500,170475,14317,15184,199976,23
438000,172029,14369,14243,200641,23
438000,171269,14272,14197,199738,25
438000,171481,14099,15629,201209,25
438000,173031,14701,14265,201997,27
438000,171232,14588,14235,200055,34
438500,173235,14359,14458,202052,34
438500,173186,14552,15013,202751,22
438500,174420,14117,14342,202879,22
438500,171154,15115,14206,200475,30
438500,171939,75938,45464,293341,28
439000,170063,14429,14222,198714,28
439000,172051,14783,14290,201124,24
439000,171747,14137,14212,200096,23
439000,178179,14983,14695,207857,23
439000,170943,14132,14450,199525,23
439500,171278,14191,14619,200088,23
439500,170644,14563,14488,199695,18
439500,171204,15091,14897,201192,18
439500,175893,14581,14796,205270,30
439500,174164,14600,14188,202952,30
440000,181960,14135,14482,210577,30
440000,175949,14541,15643,206133,25
440000,176328,14676,14239,205243,25
440000,170701,14286,14467,199454,24
440000,177703,14175,14373,206251,27
440500,173350,14356,14250,201956,27
440500,174724,14284,14540,203548,25
440500,173093,14384,14221,201698,25
440500,171468,15113,14827,201408,22
440500,172526,14218,14716,201460,26
441000,172092,14287,14657,201036,26
441000,175772,14576,14568,204916,24
441000,173086,14290,14259,201635,24
441000,172342,14162,14301,200805,20
441000,170292,14370,15017,199679,20
441500,173123,14207,14304,201634,27
441500,172521,14284,14282,201087,23
441500,172676,14552,14730,201958,23
441500,173203,14252,14687,202142,31
441500,173081,15633,15192,203906,31
442000,178814,14599,14337,207750,27
442000,173314,14593,14445,202352,22
442000,178867,14376,14332,207575,22
442000,177403,14763,14870,207036,29
442000,173898,14398,14290,202586,29
442500,174694,14500,14429,203623,24
442500,173326,14237,14729,202292,21
442500,176904,14232,14598,205734,21
442500,174895,14047,14183,203125,20
442500,175037,14371,14471,203879,20
443000,172855,14273,15841,202969,23
443000,173970,14217,14351,202538,23
443000,177054,14995,14650,206699,32
443000,175335,14279,14369,203983,26
443000,173386,14596,14462,202444,26
443500,177361,14246,14339,205946,28
443500,174365,28330,19767,222462,28
443500,177145,14316,14419,205880,34
443500,174479,14240,14366,203085,28
443500,176718,14546,14497,205761,28
444000,180916,15153,14547,210616,30
444000,173720,14252,14402,202374,25
444000,176070,14979,14392,205441,25
444000,179928,14619,14448,208995,29
444000,176912,15023,14480,206415,26
444500,173724,14512,14368,202604,26
444500,175965,14288,14458,204711,22
444500,174859,14614,14606,204079,22
444500,178582,14569,14662,207813,28
444500,173254,14625,14380,202259,26
445000,176302,14450,15927,206679,26
445000,178118,16007,18981,213106,29
445000,211638,18295,18384,248317,28
445000,177989,14219,14693,206901,28
445000,180823,14645,14557,210025,24
445500,172887,14355,14526,201768,24
445500,183226,14115,15262,212603,22
445500,178352,14308,14505,207165,25
445500,173785,14273,14491,202549,25
445500,173058,14555,14438,202051,23
446000,175711,14728,14572,205011,23
446000,180212,14804,14439,209455,27
446000,173770,14862,14402,203034,21
446000,176979,14448,14466,205893,21
446000,177757,18429,14869,211055,25
446500,176235,14517,14461,205213,25
446500,172322,14476,14426,201224,29
446500,185807,14446,15657,215910,29
446500,174501,14638,14719,203858,15
446500,173733,14354,14462,202549,28
447000,174220,14376,22789,211385,28
447000,178685,14722,14491,207898,25
447000,175306,14755,14833,204894,23
447000,175286,14385,14450,204121,23
447000,175671,14636,14800,205107,29
447500,176257,14361,14611,205229,29
447500,174911,14995,14562,204468,30
447500,177550,14497,14559,206606,28
447500,178948,15010,14518,208476,28
447500,173893,14735,14469,203097,26
448000,175718,14879,14513,205110,26
448000,176627,14475,14858,205960,26
448000,175377,14851,14832,205060,24
448000,174654,14446,14592,203692,24
448000,177312,14402,14802,206516,23
448500,175825,15427,14624,205876,30
448500,214775,15833,15799,246407,30
448500,176349,14723,14699,205771,28
448500,176901,14726,14558,206185,25
448500,175484,14886,14686,205056,25
449000,174787,14895,14805,204487,28
449000,176160,15237,15599,206996,28
449000,174649,14419,15014,204082,24
449000,175171,14478,14624,204273,27
449000,174990,14429,14842,204261,27
449500,175262,14464,14516,204242,24
449500,175098,14459,14507,204064,21
449500,173672,15285,14378,203335,21
449500,176593,14498,14828,205919,25
449500,177146,15136,14648,206930,25
450000,176496,14648,14593,205737,18
450000,176860,14959,14671,206490,18
450000,178890,16756,14728,210374,24
450000,177643,14548,14562,206753,24
450000,181544,15118,14794,211456,24
450500,194164,15737,15567,225468,25
450500,177053,14301,14921,206275,25
450500,181525,14442,14515,210482,23
450500,178202,15134,15605,208941,23
450500,176861,14460,14569,205890,29
451000,176506,14928,14784,206218,20
451000,177266,14712,14567,206545,20
451000,177605,14509,14578,206692,26
451000,188177,14594,14472,217243,26
451000,177328,14533,14690,206551,26
451500,177494,14711,14610,206815,22
451500,176908,14557,14616,206081,22
451500,176402,14476,14599,205477,23
451500,198193,14471,16938,229602,23
451500,175176,14457,16427,206060,27
452000,183442,17870,15985,217297,31
452000,192844,14564,14768,222176,31
452000,177378,14802,14914,207094,25
452000,176280,14835,14938,206053,24
452000,179113,14686,14822,208621,24
452500,177269,14537,14610,206416,27
452500,178911,14526,14956,208393,27
452500,184681,14537,14836,214054,20
452500,175287,14551,14640,204478,30
452500,176351,15077,15123,206551,30
453000,177243,14540,15114,206897,25
453000,181608,14527,14649,210784,25
453000,177273,14977,15289,207539,23
453000,178496,15242,14861,208599,30
453000,177804,14917,19847,212568,30
453500,185196,17426,22807,225429,24
453500,178936,14466,14717,208119,30
453500,183850,15656,15285,214791,30
453500,176011,14580,14765,205356,24
453500,177237,14930,14684,206851,24
454000,175680,14608,14722,205010,24
454000,178077,15109,15332,208518,28
454000,177857,14880,14782,207519,28
454000,176531,14924,15240,206695,18
454000,179416,14662,15403,209481,24
454500,179478,14661,14701,208840,24
454500,180336,15580,14946,210862,26
454500,179140,14641,14921,208702,26
454500,182466,15039,17867,215372,27
454500,181297,15099,14581,210977,30
455000,183107,15267,14740,213114,30
455000,186999,15607,16477,219083,24
455000,181248,19680,16548,217476,26
455000,179000,14600,14684,208284,26
455000,208216,20475,16620,245311,27
455500,187205,18154,18717,224076,25
455500,182247,14808,15041,212096,25
455500,213940,17009,15441,246390,25
455500,181631,14476,14724,210831,20
455500,180907,14827,14637,210371,20
456000,180387,14909,14718,210014,20
456000,184393,14916,14926,214235,20
456000,180838,14658,14768,210264,28
456000,182599,15077,16216,213892,28
456000,198312,15614,15629,229555,18
456500,182754,15076,14738,212568,25
456500,180094,14756,17253,212103,25
456500,194751,16387,14885,226023,24
456500,180397,15144,14918,210459,22
456500,178092,14821,14694,207607,22
457000,179459,14686,14799,208944,30
457000,186337,19308,15277,220922,30
457000,180637,16405,19005,216047,30
457000,182812,14865,14958,212635,25
457000,181782,14829,15474,212085,25
457500,179517,14972,14830,209319,23
457500,178529,14671,14835,208035,25
457500,178830,14680,15298,208808,25
457500,182090,14800,15346,212236,28
457500,179590,14840,15080,209510,28
458000,179601,14881,16016,210498,31
458000,180123,17728,15211,213062,24
458000,179422,14832,15212,209466,24
458000,183147,15412,15181,213740,25
458000,180324,14846,15626,210796,25
458500,179306,14907,14880,209093,25
458500,179025,14706,14805,208536,25
458500,180100,14900,14834,209834,25
458500,180868,15379,15213,211460,26
458500,179415,14966,15406,209787,25
459000,179609,14748,14800,209157,25
459000,181667,14796,14823,211286,27
459000,179604,14712,14813,209129,23
459000,180515,14911,14832,210258,23
459000,177206,15680,14839,207725,21
459500,181085,14774,14825,210684,21
459500,179144,14806,14863,208813,22
459500,179362,14712,14846,208920,22
459500,180327,14865,15203,210395,26
459500,182276,14831,15440,212547,26
460000,179347,14759,14847,208953,26
460000,202843,15051,15464,233358,19
460000,181152,14867,14908,210927,19
460000,182753,14785,14854,212392,24
460000,181467,15138,14871,211476,24
460500,182134,15109,14937,212180,22
460500,189675,15138,15885,220698,29
460500,179770,15314,14776,209860,29
460500,183434,16072,14908,214414,24
460500,179959,15414,15124,210497,23
461000,184108,14900,14882,213890,23
461000,181505,14775,15489,211769,23
461000,184526,15114,15088,214728,23
461000,183085,14828,14973,212886,23
461000,181914,15472,15031,212417,29
461500,183264,14959,15224,213447,29
461500,181044,14929,15067,211040,17
461500,181772,14855,14894,211521,17
461500,190691,14894,15217,220802,23
461500,182550,15273,15064,212887,21
462000,181168,15213,15124,211505,21
462000,183649,22117,19020,224786,31
462000,180762,15137,15556,211455,31
462000,181854,14844,15412,212110,24
462000,181191,15410,15044,211645,27
462500,182346,14878,15066,212290,27
462500,181297,14828,15083,211208,20
462500,183730,15068,14975,213773,20
462500,195323,14852,14958,225133,23
462500,182048,15203,15035,212286,21
463000,180575,14840,14952,210367,21
463000,181395,15101,14915,211411,23
463000,180864,14857,15842,211563,23
463000,180814,15934,15132,211880,30
463000,185961,15331,15443,216735,17
463500,181014,14964,15233,211211,17
463500,181049,16161,15158,212368,25
463500,181924,15388,15187,212499,25
463500,186417,14893,14991,216301,26
463500,180384,14857,15778,211019,26
464000,182542,14715,14871,212128,26
464000,185464,15711,15933,217108,28
464000,181344,14929,15517,211790,28
464000,183218,14835,15710,213763,28
464000,180301,15057,15011,210369,32
464500,183180,15375,15460,214015,32
464500,182155,29039,17222,228416,22
464500,181754,15141,14978,211873,27
464500,182306,15174,15587,213067,27
464500,182093,15010,15389,212492,27
465000,185210,15166,15139,215515,25
465000,187102,15100,16232,218434,25
465000,181845,14969,15808,212622,26
465000,183631,15149,15339,214119,26
465000,192697,15663,17561,225921,26
465500,181891,15547,15200,212638,24
465500,213914,18445,19543,251902,24
465500,210978,14802,14977,240757,22
465500,182959,14779,14846,212584,24
465500,185162,15232,15438,215832,24
466000,184275,15401,15718,215394,27
466000,187256,31320,26508,245084,26
466000,182656,14936,15682,213274,26
466000,181032,15190,15189,211411,24
466000,182758,15087,15521,213366,23
466500,184250,14960,15247,214457,23
466500,183290,15414,15866,214570,28
466500,183881,16333,15698,215912,28
466500,192945,21516,19275,233736,25
466500,183392,14959,15080,213431,19
467000,184425,15016,15067,214508,19
467000,204775,15456,15058,235289,25
467000,182027,14969,15291,212287,25
467000,185771,15020,15371,216162,28
467000,184866,15155,15215,215236,21
467500,185352,15186,15126,215664,21
467500,182503,14986,15055,212544,25
467500,181692,15189,15071,211952,25
467500,182620,15278,16205,214103,21
467500,185035,15177,15164,215376,28
468000,184650,15158,15674,215482,28
468000,183776,15223,15325,214324,24
468000,184093,15658,15140,214891,23
468000,191483,17874,15271,224628,23
468000,185197,15569,15543,216309,29
468500,189380,15835,15588,220803,29
468500,186225,15055,15462,216742,25
468500,184390,15011,15586,214987,26
468500,183511,15337,15342,214190,26
468500,182724,17481,15323,215528,26
469000,182265,15026,15029,212320,25
469000,185814,15178,15263,216255,25
469000,183017,15870,15351,214238,24
469000,186501,15025,15119,216645,22
469000,185328,15199,15729,216256,22
469500,184582,15644,16948,217174,27
469500,183439,15746,16306,215491,27
469500,204932,14905,15854,235691,20
469500,184860,30056,15713,230629,21
469500,186733,15086,15142,216961,21
470000,182913,15196,15412,213521,26
470000,180570,14950,15300,210820,26
470000,182546,15263,18999,216808,21
470000,187625,15789,18641,222055,27
470000,188471,14878,15014,218363,27
470500,184622,14857,15034,214513,26
470500,212436,19891,17924,250251,26
470500,200503,17116,16957,234576,26
470500,187971,15060,15166,218197,23
470500,180628,14994,16375,211997,29
471000,190161,15168,16246,221575,29
471000,186981,15084,15463,217528,23
471000,185832,15128,15199,216159,22
471000,206831,15125,15591,237547,22
471000,204475,15625,16028,236128,28
471500,185312,15513,16503,217328,28
471500,184628,15611,15443,215682,26
471500,198183,15892,15447,229522,32
471500,188183,15073,15974,219230,32
471500,186459,15117,15825,217401,16
472000,185430,15206,15339,215975,25
472000,186201,15125,15665,216991,25
472000,189005,15235,15636,219876,25
472000,183358,15124,15398,213880,26
472000,185575,15173,15276,216024,26
472500,185789,16168,15504,217461,27
472500,184469,15401,15317,215187,27
472500,186207,15625,15269,217101,19
472500,203758,15173,15968,234899,28
472500,184619,15957,16164,216740,28
473000,186604,15364,16009,217977,22
473000,205028,16674,15238,236940,19
473000,187729,16186,15621,219536,19
473000,187316,15544,15316,218176,25
473000,189744,16796,15474,222014,25
473500,187297,16595,16014,219906,29
473500,188728,15829,15427,219984,23
473500,185647,15251,16212,217110,23
473500,184327,15277,15322,214926,29
473500,187037,15276,15304,217617,17
474000,185844,15471,15860,217175,17
474000,187477,15183,15490,218150,19
474000,186064,15335,15819,217218,19
474000,189930,15359,15993,221282,27
474000,188057,15563,15421,219041,27
474500,186434,16209,15874,218517,28
474500,190123,15911,15323,221357,26
474500,185333,15239,15709,216281,26
474500,186122,15343,15913,217378,25
474500,185396,15214,15441,216051,25
475000,185660,15266,15333,216259,25
475000,187962,15416,15326,218704,21
475000,188414,15240,15490,219144,21
475000,189751,15210,15623,220584,23
475000,187454,15213,15298,217965,27
475500,186216,15093,15470,216779,27
475500,210518,19115,18982,248615,23
475500,184676,15796,15269,215741,33
475500,188786,15073,15374,219233,33
475500,190673,16110,16799,223582,21
476000,188540,15838,16128,220506,33
476000,189134,15904,15706,220744,34
476000,189965,15954,15847,221766,34
476000,187948,15579,15648,219175,24
476000,187012,15256,15479,217747,22
476500,204079,15382,15633,235094,22
476500,188799,29401,22728,240928,28
476500,190425,16393,15716,222534,24
476500,186658,15472,15719,217849,24
476500,185699,15477,16506,217682,29
477000,189454,15870,15402,220726,29
477000,189492,15482,15715,220689,20
477000,189173,15406,15444,220023,25
477000,187444,15303,15477,218224,25
477000,191047,15388,15434,221869,27
477500,188453,16130,15878,220461,27
477500,190607,15326,15249,221182,27
477500,196371,15312,15413,227096,20
477500,190618,15311,15784,221713,24
477500,192351,15400,16054,223805,24
478000,187415,15469,15803,218687,27
478000,200457,31761,23390,255608,27
478000,190069,18590,15811,224470,27
478000,187325,16522,16023,219870,28
478000,188047,15628,15415,219090,17
478500,186568,15315,15870,217753,17
478500,190191,15177,15947,221315,21
478500,187615,15312,15421,218348,21
478500,191742,15342,20777,227861,24
478500,197927,15944,15846,229717,24
479000,187788,15367,15585,218740,29
479000,188721,15686,15966,220373,28
479000,191988,15465,15954,223407,28
479000,189431,15685,15692,220808,31
479000,191442,15476,15613,222531,24
479500,190290,15942,16036,222268,24
479500,206974,16769,17121,240864,29
479500,188362,16119,15645,220126,20
479500,188185,15674,15607,219466,20
479500,189339,16186,15563,221088,21
480000,191401,15510,15480,222391,21
480000,188261,15837,15739,219837,20
480000,212776,18985,15836,247597,28
480000,189238,15777,15934,220949,28
480000,189064,15544,16289,220897,22
480500,205681,18201,15755,239637,32
480500,187472,16383,16845,220700,32
480500,188409,15395,16199,220003,22
480500,188369,16174,15505,220048,26
480500,193862,16302,15426,225590,26
481000,190466,15890,15538,221894,20
481000,190175,15545,15881,221601,24
481000,193583,15440,15599,224622,24
481000,189280,15954,15735,220969,21
481000,188587,15650,15840,220077,21
481500,190039,15450,15835,221324,23
481500,189537,16468,15612,221617,25
481500,189094,15768,15526,220388,25
481500,197396,15900,15843,229139,24
481500,189954,15420,15538,220912,19
482000,192572,15412,15909,223893,19
482000,190399,15401,16218,222018,23
482000,190588,15451,15528,221567,23
482000,185820,15242,15643,216705,28
482000,193491,15424,15549,224464,26
482500,189519,15884,15750,221153,26
482500,188625,15455,16296,220376,26
482500,192301,16564,16135,225000,26
482500,190696,15620,15873,222189,25
482500,192277,16114,15819,224210,26
483000,190213,15514,15855,221582,26
483000,194213,15577,15599,225389,21
483000,191162,15470,15557,222189,22
483000,188880,15490,15694,220064,22
483000,189434,15759,15604,220797,24
483500,190275,15650,15568,221493,20
483500,194865,15534,15577,225976,20
483500,190915,15839,15718,222472,29
483500,192136,15585,15637,223358,29
483500,196282,15467,16182,227931,23
484000,191738,15491,15575,222804,23
484000,190665,15648,15915,222228,23
484000,189264,16127,16121,221512,22
484000,189691,15749,16428,221868,25
484000,190422,15963,15679,222064,25
484500,194783,15502,15781,226066,25
484500,192449,15645,24846,232940,25
484500,190256,16508,16593,223357,28
484500,190706,15917,16043,222666,25
484500,192838,15584,15769,224191,25
485000,191385,16502,15638,223525,27
485000,189550,15855,15919,221324,20
485000,190075,15779,15791,221645,20
485000,191732,15500,16063,223295,24
485000,196269,20202,18893,235364,28
485500,189562,16052,15762,221376,28
485500,192425,15735,16156,224316,27
485500,192656,15531,16527,224714,19
485500,195545,15581,15801,226927,19
485500,192256,16062,16173,224491,27
486000,196113,15726,15948,227787,27
486000,190116,16227,16290,222633,21
486000,194100,15854,16889,226843,31
486000,193273,16434,16472,226179,31
486000,191863,16082,15685,223630,29
486500,189981,15560,15666,221207,21
486500,192456,16280,15675,224411,21
486500,193362,15894,15865,225121,21
486500,193368,15837,15678,224883,24
486500,193977,15586,16104,225667,24
487000,192905,16016,15996,224917,24
487000,196703,16044,15907,228654,27
487000,196983,15796,15728,228507,27
487000,198991,19901,20101,238993,25
487000,197359,15731,15967,229057,18
487500,192354,15778,15727,223859,18
487500,243994,15946,16011,275951,31
487500,202449,15831,16124,234404,20
487500,192076,15655,16271,224002,20
487500,193976,15658,16578,226212,18
488000,192538,15830,15594,223962,18
488000,192701,15930,16136,224767,28
488000,192523,16799,16363,225685,25
488000,191295,15687,15792,222774,25
488000,192673,15794,15934,224401,22
488500,193755,15690,15742,225187,22
488500,194283,15737,15766,225786,24
488500,191352,15739,16069,223160,17
488500,191428,15683,15774,222885,17
488500,192407,16766,18155,227328,28
489000,201921,15625,16637,234183,28
489000,194174,15532,31329,241035,19
489000,189055,16184,16629,221868,25
489000,195187,15437,15587,226211,25
489000,224036,16392,17882,258310,21
489500,195410,15806,15735,226951,25
489500,191039,15617,16577,223233,25
489500,199130,16349,16150,231629,28
489500,194829,16616,16144,227589,35
489500,191321,15687,15989,222997,28
490000,192712,15723,17474,225909,28
490000,195070,15919,15892,226881,24
490000,201558,15923,15979,233460,31
490000,194959,16479,16755,228193,31
490000,192044,15887,16190,224121,24
490500,193589,16239,16379,226207,29
490500,192528,16154,16548,225230,29
490500,191903,15951,16454,224308,29
490500,191065,15662,16006,222733,24
490500,193028,15819,16242,225089,24
491000,193189,15975,16158,225322,26
491000,196029,15766,16205,228000,26
491000,191824,15707,16315,223846,26
491000,192067,15847,16321,224235,26
491000,195189,16298,15885,227372,23
491500,197972,16310,15823,230105,23
491500,194843,16314,15998,227155,26
491500,199121,17188,16057,232366,22
491500,193619,16159,15891,225669,22
491500,198564,22527,24557,245648,27
492000,194073,15970,16104,226147,27
492000,213614,16312,16545,246471,27
492000,197376,15813,16025,229214,32
492000,192662,17225,17497,227384,26
492000,194402,15572,15600,225574,26
492500,195913,15760,15852,227525,25
492500,195733,15595,15659,226987,36
492500,194844,15730,15821,226395,19
492500,193070,15798,15816,224684,19
492500,193109,15955,15951,225015,30
493000,204829,16538,16031,237398,30
493000,199380,16115,15980,231475,24
493000,195423,15795,15888,227106,23
493000,202534,15858,16187,234579,23
493000,196714,16054,16601,229369,28
493500,195918,15785,15904,227607,24
493500,194565,15844,31095,241504,24
493500,193418,15939,16032,225389,32
493500,197115,15769,15873,228757,24
493500,197980,15763,15869,229612,20
494000,193471,15814,16131,225416,20
494000,194837,15820,16060,226717,26
494000,193840,15940,16339,226119,26
494000,197544,16121,15895,229560,25
494000,196681,16401,16100,229182,24
494500,203196,16086,16118,235400,24
494500,195722,17210,16056,228988,25
494500,193204,15822,15928,224954,25
494500,194290,15923,15964,226177,25
494500,212300,16458,16162,244920,29
495000,199498,16022,15959,231479,19
495000,193307,15814,15917,225038,19
495000,197848,16009,16702,230559,31
495000,194524,16371,15923,226818,20
495000,196479,15815,16007,228301,20
495500,194363,16212,16305,226880,29
495500,195216,16497,15988,227701,29
495500,194551,15877,15968,226396,22
495500,195348,15882,16106,227336,22
495500,194970,16173,16009,227152,22
496000,198237,15920,16689,230846,28
496000,208778,19169,16138,244085,23
496000,195393,16161,16249,227803,23
496000,193188,15852,15954,224994,23
496000,193346,20712,19404,233462,26
496500,193029,15864,16634,225527,26
496500,197876,15984,16023,229883,29
496500,193329,15867,16028,225224,22
496500,203006,25066,23875,251947,22
496500,199427,16621,16433,232481,27
497000,194347,15877,15994,226218,19
497000,196132,15932,16148,228212,19
497000,195206,15886,16028,227120,29
497000,194648,16129,16079,226856,29
497000,194517,16298,16255,227070,28
497500,194933,16181,16404,227518,26
497500,208981,15944,16020,240945,26
497500,195497,15918,16090,227505,23
497500,193756,16086,16052,225894,22
497500,196274,15885,16234,228393,22
498000,194124,15912,15991,226027,24
498000,194396,15966,16066,226428,22
498000,196606,15912,16021,228539,22
498000,205386,22024,16224,243634,22
498000,196125,16029,16012,228166,22
498500,197466,16090,16115,229671,23
498500,193944,16370,16088,226402,29
498500,195047,16116,16420,227583,29
498500,195690,15951,16040,227681,22
498500,213669,15952,16074,245695,19
499000,194583,16181,16035,226799,19
499000,190971,21383,27628,239982,29
499000,195457,16384,17154,228995,25
499000,195543,15941,16061,227545,25
499000,197577,15931,17030,230538,21
499500,194521,15949,16143,226613,25
499500,217501,15991,16625,250117,25
499500,212973,19693,21763,254429,23
499500,194251,15969,17020,227240,25
499500,193857,15947,16538,226342,25
500000,194718,16009,16611,227338,26
500000,195112,15998,16080,227190,18
500000,198393,17270,16429,232092,18
500000,195876,16325,16157,228358,24
500000,195479,15976,16092,227547,24
500500,197689,16273,16342,230304,19
500500,197306,15986,16135,229427,19
500500,196335,16327,16508,229170,31
500500,195056,16295,16091,227442,21
500500,195433,16172,16421,228026,21
501000,216258,17811,17525,251594,22
501000,210510,16031,16269,242810,28
501000,205750,16398,16246,238394,28
501000,218537,16578,16551,251666,25
501000,202682,17074,16870,236626,29
501500,200839,16272,16146,233257,21
501500,196666,16015,16126,228807,21
501500,199234,16035,16078,231347,27
501500,196985,18366,16260,231611,27
501500,200816,16222,16768,233806,21
502000,200899,16058,16110,233067,22
502000,199437,16531,16155,232123,22
502000,198618,16464,16632,231714,27
502000,197886,16063,16179,230128,26
502000,196556,16103,16214,228873,26
502500,201485,16052,16164,233701,22
502500,197435,16115,16165,229715,29
502500,196782,16520,16550,229852,29
502500,195786,16044,16205,228035,29
502500,198171,16062,16573,230806,32
503000,195604,16153,16207,227964,26
503000,196074,16137,16183,228394,26
503000,199490,16241,16164,231895,22
503000,197703,16178,16395,230276,27
503000,207619,16374,16317,240310,27
503500,200335,16117,16210,232662,29
503500,207999,16451,17237,241687,30
503500,200135,16227,16210,232572,22
503500,196446,16277,16565,229288,22
503500,207979,17726,16802,242507,26
504000,200971,16665,16624,234260,26
504000,196993,16407,16303,229703,22
504000,224056,20326,19128,263510,27
504000,200331,17222,19548,237101,27
504000,209599,15912,17324,242835,17
504500,213054,16370,16292,245716,25
504500,228074,15980,16085,260139,25
504500,196230,16128,16181,228539,29
504500,197011,16119,16265,229395,26
504500,197905,16394,16264,230563,28
505000,198286,16130,16232,230648,28
505000,198156,16117,16221,230494,25
505000,198115,16164,16447,230726,25
505000,198489,16132,16229,230850,25
505000,198305,16645,16232,231182,33
505500,199648,16164,16282,232094,27
505500,197938,16174,16300,230412,27
505500,198956,16645,16311,231912,27
505500,243851,16357,16468,276676,21
505500,200516,16158,16276,232950,21
506000,203680,16239,16512,236431,21
506000,198611,16615,16567,231793,26
506000,201241,16224,16423,233888,26
506000,200821,16528,16263,233612,26
506000,199566,17033,16693,233292,28
506500,201570,16178,16348,234096,28
506500,199638,16212,16819,232669,24
506500,198696,16250,16275,231221,24
506500,219351,17024,16893,253268,24
506500,200657,16117,16267,233041,24
507000,200700,16212,16383,233295,25
507000,202277,16218,17034,235529,25
507000,198794,16237,16827,231858,26
507000,199583,16333,16315,232231,28
507000,198696,16705,16720,232121,26
507500,198066,17826,16815,232707,26
507500,199744,16238,16323,232305,22
507500,197600,16347,16445,230392,32
507500,198319,16276,16544,231139,32
507500,199442,16549,16599,232590,27
508000,204786,16289,16373,237448,22
508000,199977,16529,17262,233768,22
508000,201639,16229,16605,234473,23
508000,214502,16231,16364,247097,24
508000,201928,16357,16409,234694,24
508500,199394,16232,16309,231935,24
508500,199017,16245,16348,231610,19
508500,200476,16369,16780,233625,19
508500,199549,16664,16339,232552,22
508500,199681,16815,16801,233297,22
509000,207628,16896,17072,241596,22
509000,203982,22195,16844,243021,25
509000,199606,16218,16378,232202,25
509000,203010,16259,16514,235783,25
509000,200103,16306,16383,232792,18
509500,199932,16284,16412,232628,18
509500,202566,16482,18556,237604,27
509500,201793,16963,17013,235769,20
509500,223749,16555,16213,256517,20
509500,200526,16317,16364,233207,20
510000,201054,16369,16400,233823,20
510000,200638,16311,16412,233361,22
510000,210485,16286,16449,243220,30
510000,219636,16745,16744,253125,30
510000,204627,16310,16399,237336,21
510500,201785,16296,16417,234498,23
510500,202644,19077,48157,269878,23
510500,207975,16320,16450,240745,22
510500,201390,16327,16488,234205,25
510500,202899,16307,16832,236038,25
511000,208991,16430,16710,242131,25
511000,201570,17134,16417,235121,22
511000,199712,16299,16434,232445,22
511000,223844,16675,16492,257011,24
511000,200144,16324,16587,233055,28
511500,201762,16572,16890,235224,28
511500,206812,17720,17584,242116,29
511500,200701,16308,16785,233794,25
511500,201707,16601,16986,235294,30
511500,210236,16572,16587,243395,30
512000,202083,16418,16495,234996,29
512000,215974,16369,16689,249032,21
512000,200947,16507,16478,233932,21
512000,202280,16359,17391,236030,25
512000,211159,16342,16445,243946,22
512500,199542,16547,16610,232699,22
512500,200476,16745,16989,234210,26
512500,205920,16736,16807,239463,22
512500,217790,16348,16611,250749,22
512500,199911,16390,16594,232895,25
513000,203235,16494,16568,236297,29
513000,202823,16504,16583,235910,29
513000,202057,16693,16488,235238,30
513000,212810,16382,16467,245659,25
513000,201482,16762,16495,234739,24
513500,203014,16583,16548,236145,24
513500,220358,16633,16893,253884,27
513500,203076,16695,16935,236706,25
513500,202583,16293,16666,235542,25
513500,200323,16416,16511,233250,22
514000,204489,16748,16757,237994,22
514000,201518,17314,17268,236100,22
514000,204382,16561,16651,237594,29
514000,214783,16377,16462,247622,25
514000,202484,16503,19265,238252,25
514500,203067,16469,16594,236130,28
514500,203332,16786,16817,236935,28
514500,203084,17119,17252,237455,28
514500,205740,16593,16488,238821,23
514500,200699,16606,16567,233872,27
515000,204701,16687,17002,238390,27
515000,220433,16636,16615,253684,23
515000,203985,16487,17295,237767,22
515000,204568,16847,16561,237976,22
515000,201153,16446,16900,234499,25
515500,203679,16523,16933,237135,25
515500,202242,16448,16652,235342,25
515500,203283,16516,16542,236341,23
515500,203327,16671,17070,237068,27
515500,224921,16619,17276,258816,27
516000,204134,16736,16618,237488,20
516000,202744,16764,17134,236642,21
516000,201442,16803,16596,234841,21
516000,203046,17787,16675,237508,19
516000,207283,17035,17638,241956,33
516500,201446,16893,16661,235000,33
516500,210888,16818,17006,244712,27
516500,205294,17032,16624,238950,26
516500,204261,16510,16618,237389,19
516500,203385,16529,17026,236940,19
517000,204718,17167,16651,238536,26
517000,206070,16710,16625,239405,28
517000,204890,17409,17613,239912,28
517000,216628,17275,17664,251567,24
517000,205318,18055,17512,240885,30
517500,206025,17012,16710,239747,30
517500,202917,16522,16656,236095,25
517500,202783,16582,18163,237528,30
517500,202410,18280,16659,237349,17
517500,207215,17017,16944,241176,17
518000,212672,17077,17394,247143,30
518000,218811,16826,16710,252347,19
518000,248336,20331,20386,289053,19
518000,205248,16583,16746,238577,32
518000,202613,16524,16632,235769,25
518500,199273,16385,16523,232181,25
518500,203149,16948,16773,236870,25
518500,203670,16558,16747,236975,24
518500,202534,17103,25885,245522,24
518500,204535,17016,17197,238748,30
519000,206326,17042,17134,240502,31
519000,204582,16607,16671,237860,16
519000,204887,17769,16659,239315,16
519000,203689,16618,16681,236988,22
519000,204948,16837,17090,238875,22
519500,204253,17748,16740,238741,26
519500,231063,24129,22476,277668,22
519500,203683,16620,16704,237007,22
519500,203109,16557,16829,236495,21
519500,203511,16973,17079,237563,26
520000,204888,16693,16917,238498,26
520000,209844,16719,17238,243801,23
520000,204216,16816,16872,237904,26
520000,223872,17621,18683,260176,26
520000,204938,16595,17135,238668,24
520500,203656,16664,16715,237035,21
520500,202574,16774,19956,239304,21
520500,206437,17041,16893,240371,28
520500,204584,17299,16950,238833,27
520500,203824,16635,16757,237216,27
521000,206901,16766,16794,240461,28
521000,223458,16978,16766,257202,21
521000,205020,16655,16737,238412,21
521000,209118,16890,16897,242905,25
521000,204804,16609,16762,238175,22
521500,204291,16646,16963,237900,22
521500,209636,16902,16997,243535,18
521500,204009,16674,16797,237480,25
521500,205021,18860,16996,240877,25
521500,206974,16769,18211,241954,24
522000,205134,16653,16860,238647,22
522000,204410,16700,17060,238170,22
522000,204981,16861,16784,238626,24
522000,204693,17246,18477,240416,25
522000,207195,17026,17200,241421,25
522500,207152,17048,16986,241186,28
522500,207154,16670,16774,240598,21
522500,206979,16767,16923,240669,21
522500,206377,17113,16731,240221,25
522500,206639,16501,16627,239767,24
523000,206102,17009,17498,240609,24
523000,207757,16984,17143,241884,23
523000,206781,16659,17056,240496,22
523000,205377,17039,19122,241538,22
523000,207153,16713,17465,241331,23
523500,205695,16753,17037,239485,18
523500,206067,16699,16822,239588,18
523500,207282,18297,17176,242755,27
523500,207269,16704,16819,240792,23
523500,206545,16995,16902,240442,23
524000,204769,17115,17553,239437,24
524000,229492,16931,16919,263342,26
524000,205789,17086,17155,240030,26
524000,206979,17165,17201,241345,26
524000,205156,17211,17158,239525,27
524500,207824,17030,16955,241809,27
524500,206643,16997,17208,240848,25
524500,204913,16719,16827,238459,19
524500,206060,16769,17193,240022,19
524500,207358,16892,16858,241108,27
525000,205640,16845,16950,239435,29
525000,207213,16773,17059,241045,28
525000,206586,16916,16866,240368,28
525000,206018,17036,16837,239891,21
525000,208967,16709,16813,242489,20
525500,206856,16820,16867,240543,20
525500,206898,16854,16877,240629,20
525500,207439,16746,17602,241787,20
525500,209415,16792,16841,243048,20
525500,207467,16852,17379,241698,29
526000,206136,16840,17538,240514,29
526000,215334,17019,17017,249370,25
526000,206775,17253,17053,241081,27
526000,223062,18471,19390,260923,26
526000,211956,16874,17548,246378,26
526500,226684,17134,17161,260979,24
526500,210336,16842,17352,244530,22
526500,207038,16812,16936,240786,22
526500,210622,16765,16934,244321,21
526500,206473,16864,17521,240858,23
527000,207891,17057,17029,241977,23
527000,208205,17534,17363,243102,25
527000,206801,16824,16910,240535,20
527000,208787,16927,16946,242660,20
527000,216716,17329,18393,252438,26
527500,206539,16809,17088,240436,31
527500,219494,16918,17465,253877,24
527500,206781,17013,17278,241072,24
527500,206469,16839,16951,240259,23
527500,212666,16796,16949,246411,21
528000,209945,16880,17239,244064,21
528000,211051,17450,17377,245878,29
528000,209267,17097,17205,243569,32
528000,219428,16871,17068,253367,32
528000,207790,16817,17844,242451,19
528500,211109,17207,17081,245397,18
528500,223020,22310,18055,263385,18
528500,214676,17315,17157,249148,23
528500,211967,17261,17404,246632,26
528500,242955,16994,17197,277146,26
529000,210334,16887,17682,244903,25
529000,234168,24935,22981,282084,21
529000,207702,16981,17016,241699,28
529000,206804,17020,16986,240810,28
529000,214916,16898,17204,249018,26
529500,209662,17185,17304,244151,28
529500,215049,17177,17268,249494,28
529500,212121,17381,16979,246481,24
529500,223113,16661,17704,257478,27
529500,214166,22613,18409,255188,32
530000,213684,17363,17053,248100,21
530000,212348,17140,17216,246704,21
530000,209923,16914,16994,243831,23
530000,212476,16871,17011,246358,23
530000,220982,16921,16979,254882,24
530500,210638,16897,17020,244555,26
530500,210771,16900,17025,244696,27
530500,207566,16880,17225,241671,27
530500,209927,16906,17052,243885,20
530500,215767,16954,16995,249716,28
531000,209366,16967,17080,243413,28
531000,225601,16930,17215,259746,22
531000,215676,16948,17038,249662,28
531000,209615,16944,17390,243949,28
531000,208513,16866,17037,242416,24
531500,212288,17079,17863,247230,28
531500,211970,16967,17226,246163,25
531500,209471,16997,17050,243518,25
531500,218324,17647,17131,253102,26
531500,219707,17822,17057,254586,25
532000,211723,18947,19374,250044,25
532000,215308,17014,17064,249386,26
532000,210633,17356,18931,246920,26
532000,208914,17019,17105,243038,25
532000,214662,17206,17412,249280,25
532500,209730,17191,17158,244079,17
532500,209544,17674,17148,244366,25
532500,212970,16863,16928,246761,25
532500,217973,21521,20519,260013,22
532500,214337,17603,17605,249545,30
533000,215799,16983,17079,249861,30
533000,229650,17028,17377,264055,22
533000,218612,22710,20716,262038,26
533000,213978,17507,17630,249115,27
533000,213607,25553,21411,260571,27
533500,219501,18387,18580,256468,20
533500,214668,18062,19787,252517,23
533500,211465,17052,17338,245855,29
533500,215493,17609,17897,250999,29
533500,209813,36213,21259,267285,30
534000,226059,17344,17478,260881,26
534000,210897,17163,17319,245379,23
534000,214778,17235,17674,249687,23
534000,216077,17069,17157,250303,24
534000,234238,17326,17323,268887,21
534500,216051,17568,17725,251344,21
534500,213463,17155,17292,247910,22
534500,211692,17087,17172,245951,23
534500,213051,17449,17651,248151,23
534500,224935,17660,17233,259828,21
535000,214693,17254,17446,249393,26
535000,226386,17155,17291,260832,26
535000,211248,17155,17505,245908,33
535000,214788,17094,17200,249082,24
535000,220221,17069,17408,254698,25
535500,210536,17110,17199,244845,25
535500,214677,17296,17392,249365,19
535500,216153,17257,17936,251346,23
535500,215401,17325,17322,250048,23
535500,212184,17101,17183,246468,27
536000,216255,17687,17183,251125,26
536000,240024,17126,17219,274369,24
536000,213032,17465,17391,247888,24
536000,209705,17977,19949,247631,25
536000,215153,17145,18122,250420,27
536500,212147,17209,17419,246775,27
536500,211502,17150,17208,245860,26
536500,213688,18555,17526,249769,23
536500,213909,17207,17233,248349,25
536500,212481,17198,17473,247152,25
537000,212858,17233,17655,247746,24
537000,212724,17229,17352,247305,30
537000,216268,17418,17800,251486,30
537000,212100,17126,17291,246517,26
537000,216857,26509,19365,262731,27
537500,211982,17124,17255,246361,26
537500,218427,17298,17484,253209,25
537500,218154,17281,17497,252932,25
537500,212078,17899,17465,247442,28
537500,215217,19265,17344,251826,23
538000,213339,17149,17846,248334,23
538000,217102,17677,17659,252438,25
538000,213407,17153,17260,247820,18
538000,213757,17199,17405,248361,18
538000,214080,17271,17399,248750,26
538500,211602,17153,18350,247105,24
538500,212297,17180,17550,247027,24
538500,213008,17181,17281,247470,21
538500,222651,24370,19791,266812,28
538500,212020,17454,17283,246757,28
539000,214336,17284,17142,248762,24
539000,229881,17047,17126,264054,24
539000,213649,17206,17431,248286,24
539000,213458,17261,17381,248100,24
539000,211491,17589,17314,246394,23
539500,211766,17301,17463,246530,28
539500,212410,17206,17313,246929,28
539500,224024,17220,17320,258564,21
539500,208038,16944,17202,242184,24
539500,208990,17417,17230,243637,22
540000,213849,17310,17651,248810,22
540000,221419,17844,19094,258357,26
540000,213900,17218,17328,248446,28
540000,213032,17271,17310,247613,28
540000,214671,17228,17330,249229,23
540500,217477,17284,17344,252105,23
540500,223720,21279,21258,266257,23
540500,213626,17244,17347,248217,22
540500,217248,17244,17521,252013,16
540500,215486,17208,17806,250500,16
541000,214085,17252,17356,248693,24
541000,218506,17285,17349,253140,23
541000,215074,17303,17524,249901,23
541000,213564,17401,17588,248553,33
541000,215375,17347,17501,250223,27
541500,215511,17290,17361,250162,27
541500,214343,17300,17591,249234,27
541500,217907,17239,17422,252568,28
541500,217540,17760,17646,252946,25
541500,214993,17580,17416,249989,29
542000,214044,17316,17506,248866,29
542000,214953,17281,17608,249842,23
542000,215411,17511,17367,250289,28
542000,211983,17284,17379,246646,19
542000,212626,17467,17869,247962,19
542500,214972,17324,17561,249857,23
542500,249997,17315,17468,284780,29
542500,218006,17648,17814,253468,29
542500,219316,18058,17618,254992,31
542500,214995,17812,17666,250473,30
543000,217150,17279,17362,251791,26
543000,230409,18932,19278,268619,23
543000,225251,18291,18208,261750,23
543000,217110,17421,17563,252094,20
543000,220940,18449,18481,257870,24
543500,215123,18067,18035,251225,24
543500,219097,17559,17530,254186,22
543500,220379,20288,23451,264118,26
543500,218070,18312,18051,254433,26
543500,220931,17896,18010,256837,31
544000,218710,17549,17659,253918,24
544000,219751,17728,17578,255057,24
544000,220195,17611,17514,255320,24
544000,238994,18022,18004,275020,23
544000,223236,17965,17829,259030,20
544500,222778,18728,18159,259665,23
544500,233480,18320,18413,270213,23
544500,219108,17573,17654,254335,24
544500,219362,18037,17782,255181,29
544500,243616,20073,18010,281699,29
545000,229031,17417,20824,267272,24
545000,227987,17650,18003,263640,28
545000,222321,17487,17480,257288,25
545000,225341,17517,17514,260372,24
545000,214713,17800,17697,250210,24
545500,215054,17492,17586,250132,24
545500,216209,17913,17946,252068,25
545500,216491,17369,17577,251437,25
545500,216602,17521,17655,251778,25
545500,217782,17403,17716,252901,28
546000,216196,17389,17584,251169,18
546000,215876,17409,17724,251009,18
546000,218368,17431,17558,253357,29
546000,218867,17753,17947,254567,32
546000,218923,17524,17735,254182,30
546500,216074,17408,17931,251413,30
546500,224156,17410,17618,259184,26
546500,226571,18014,18230,262815,22
546500,215965,17518,17564,251047,27
546500,220716,17439,17532,255687,27
547000,216631,17400,17329,251360,25
547000,219951,17974,17759,255684,22
547000,221671,17804,17728,257203,20
547000,259154,17266,17383,293803,20
547000,221704,17345,17581,256630,28
547500,244113,17905,18063,280081,27
547500,273252,18279,19521,311052,27
547500,225359,17909,17776,261044,27
547500,226181,18452,18376,263009,22
547500,222828,18707,18224,259759,25
548000,219316,18742,18586,256644,19
548000,219000,17943,19872,256815,19
548000,234871,17490,17696,270057,25
548000,221310,17563,18083,256956,21
548000,220212,17587,18006,255805,21
548500,217637,18872,18009,254518,22
548500,217073,17507,17589,252169,27
548500,219034,17500,17582,254116,27
548500,216955,17544,18063,252562,25
548500,225665,19138,19074,263877,27
549000,220046,17533,17682,255261,27
549000,221782,17544,17871,257197,27
549000,237992,17489,17562,273043,20
549000,222754,17610,17695,258059,26
549000,224658,17825,17910,260393,21
549500,229918,17534,17720,265172,21
549500,237021,17525,17686,272232,21
549500,224283,17980,17632,259895,24
549500,226339,17796,18073,262208,24
549500,239815,17914,18101,275830,25
550000,217427,17676,17639,252742,27
550000,240814,17889,17984,276687,17
550000,220328,17764,17757,255849,17
550000,220888,17788,18165,256841,27
550000,220054,18994,18707,257755,21
550500,219517,17668,17745,254930,21
550500,234263,17970,17995,270228,27
550500,223249,17545,17674,258468,30
550500,218472,17517,17796,253785,30
550500,224126,17592,17683,259401,23
551000,221034,17551,17895,256480,23
551000,218909,17821,17750,254480,26
551000,219081,17575,17668,254324,26
551000,220655,17956,18235,256846,26
551000,221463,17722,18043,257228,30
551500,221002,17603,17716,256321,28
551500,222860,17630,17717,258207,26
551500,225764,17889,18592,262245,26
551500,220971,17594,17732,256297,23
551500,220454,17651,18258,256363,23
552000,218727,17673,18251,254651,23
552500,219607,17591,17782,254980,23
552500,215854,17519,17696,251069,28
552500,217689,17556,17632,252877,21
552500,220183,17566,17631,255380,21
552500,210622,17119,17155,244896,24
553000,210842,17064,17216,245122,24
553000,240289,17084,17322,274695,24
553000,210531,17164,17246,244941,31
553000,219032,17634,17717,254383,25
553000,219432,17767,17648,254847,23
553500,224679,18069,18654,261402,23
553500,227312,17900,18085,263297,24
553500,219705,18152,18057,255914,22
553500,217518,18411,17668,253597,27
553500,223092,17619,17882,258593,27
554000,219080,17566,17699,254345,24
554000,229408,17247,17248,263903,24
554000,228757,17652,17853,264262,24
554000,220308,18042,18013,256363,31
554000,221381,18137,18387,257905,25
554500,221930,17773,18150,257853,22
554500,244508,19077,18357,281942,22
554500,218883,17612,17708,254203,30
554500,237856,17353,18130,273339,26
554500,211896,17126,17242,246264,26
555000,211994,17391,17474,246859,32
555000,241148,17219,17394,275761,32
555000,213277,17386,17234,247897,23
555000,219265,17354,17299,253918,21
555000,216374,19229,18162,253765,22
555500,223350,18393,17855,259598,22
555500,229046,17994,17825,264865,25
555500,225367,18110,18303,261780,32
555500,233964,18214,17885,270063,26
555500,219183,17615,17782,254580,26
556000,223909,17739,17804,259452,27
556000,221348,18074,17761,257183,28
556000,225375,17631,18008,261014,30
556000,219049,18335,18116,255500,27
556000,217779,17747,17746,253272,27
556500,218246,17684,18165,254095,24
556500,226795,17677,17759,262231,23
556500,218291,17634,17794,253719,22
556500,220279,18095,18134,256508,22
556500,212660,17152,17717,247529,23
557000,213993,17175,17299,248467,23
557000,244877,18110,18145,281132,23
557000,224158,18102,18566,260826,24
557000,220362,18283,18216,256861,22
557000,221233,17869,18084,257186,22
557500,220802,17953,17826,256581,26
557500,229027,17825,17799,264651,24
557500,214544,17200,17375,249119,27
557500,224296,18474,18587,261357,27
557500,221387,17786,18059,257232,25
558000,228986,18152,18316,265454,24
558000,238858,18533,17677,275068,26
558000,221137,18022,18014,257173,26
558000,220911,18336,18211,257458,20
558000,222902,18237,18179,259318,23
558500,223375,18331,18284,259990,29
558500,221560,18018,18732,258310,29
558500,224323,17738,17646,259707,27
558500,228376,17258,17378,263012,25
558500,222849,17895,17881,258625,29
559000,220435,17814,17854,256103,23
559000,232746,18611,18710,270067,23
559000,233986,17791,17873,269650,26
559000,227582,18273,18281,264136,25
559000,221643,17770,17902,257315,25
559500,222177,17974,18055,258206,27
559500,234082,17793,18473,270348,25
559500,227766,17976,17883,263625,25
559500,222901,17792,17909,258602,25
559500,221383,17829,18079,257291,22
560000,224207,17762,17856,259825,30
560000,235540,18076,18202,271818,21
560000,223704,17975,18202,259881,21
560000,222717,17802,18614,259133,25
560000,224962,17850,17914,260726,19
560500,223791,18123,18001,259915,19
560500,233246,18012,17939,269197,28
560500,220319,17811,17905,256035,24
560500,231235,18363,18061,267659,25
560500,217663,19378,18805,255846,25
561000,218462,17285,17475,253222,13
561000,223760,18184,18814,260758,28
561000,215065,17353,17512,249930,28
561000,218242,17738,17500,253480,23
561000,222827,18305,18203,259335,21
561500,221932,17893,17918,257743,22
561500,232153,17915,18110,268178,22
561500,224163,17966,17779,259908,23
561500,221494,17783,17975,257252,25
561500,223987,18119,18269,260375,25
562000,225377,19028,18310,262715,23
562000,234553,17822,17977,270352,26
562000,227551,18965,18364,264880,24
562000,225239,17852,17997,261088,24
562000,227507,17851,17956,263314,26
562500,228555,18753,18370,265678,28
562500,229770,17983,18222,265975,26
562500,225372,17963,18020,261355,26
562500,220964,17888,17996,256848,27
562500,227569,17846,18491,263906,25
563000,222681,17877,18333,258891,24
563000,226546,17458,17683,261687,24
563000,220994,17516,17569,256079,27
563000,222046,17866,18489,258401,25
563000,229155,23952,23113,276220,36
563500,276528,22800,23133,322461,24
563500,222342,17902,17992,258236,24
563500,223385,17871,18184,259440,23
563500,222728,18059,18162,258949,23
563500,222829,17937,18036,258802,21
564000,218977,17538,18449,254964,21
564000,230623,17848,17661,266132,22
564000,224412,17935,18062,260409,22
564000,224704,17919,18071,260694,22
564000,220708,18977,19513,259198,23
564500,217003,17480,17779,252262,29
564500,228765,17520,17765,264050,25
564500,222018,19433,19008,260459,25
564500,221764,18114,18062,257940,24
564500,227757,18176,18169,264102,25
565000,224004,17950,18079,260033,25
565000,236766,17932,18055,272753,26
565000,225036,17914,18168,261118,21
565000,227303,18290,18387,263980,25
565000,225913,18119,18285,262317,25
565500,223687,17978,18107,259772,25
565500,227898,18018,19091,265007,20
565500,225579,18569,18589,262737,30
565500,223796,17979,18081,259856,30
565500,223159,17959,18081,259199,26
566000,235474,18613,18586,272673,24
566000,228207,18090,18234,264531,23
566000,226834,18284,18407,263525,23
566000,228274,18070,18099,264443,20
566000,222988,17960,18123,259071,26
566500,224723,18661,18267,261651,18
566500,230677,18122,19911,268710,18
566500,224067,18292,18202,260561,21
566500,223793,18067,18092,259952,22
566500,226520,18002,18098,262620,22
567000,226437,18484,18812,263733,23
567000,232109,20026,18470,270605,27
567000,225946,18064,17793,261803,27
567000,222340,17583,17780,257703,22
567000,230998,18039,18177,267214,24
567500,223592,18207,18142,259941,27
567500,223260,18046,18125,259431,27
567500,227210,18344,18762,264316,26
567500,254902,18499,21020,294421,18
567500,218764,17645,17754,254163,21
568000,220794,17601,17742,256137,21
568000,229050,17621,17837,264508,26
568000,220087,17973,17807,255867,23
568000,234268,18534,18556,271358,23
568000,226916,18068,18178,263162,32
568500,221405,17966,17884,257255,26
568500,232792,17646,17836,268274,32
568500,218939,17654,19207,255800,20
568500,218762,17636,17769,254167,20
568500,228134,17785,18654,264573,21
569000,219905,17635,17787,255327,33
569000,228453,18014,18243,264710,19
569000,227997,18466,18663,265126,19
569000,225612,18121,18178,261911,28
569000,225996,17806,19842,263644,29
569500,232408,17931,17917,268256,21
569500,232121,19646,19086,270853,21
569500,220803,17633,17782,256218,22
569500,218386,17897,19526,255809,29
569500,221314,17783,17853,256950,29
570000,225108,20257,18843,264208,20
570000,271480,18397,18573,308450,26
570000,227391,18165,18340,263896,20
570000,227878,18546,18544,264968,20
570000,225288,18863,18708,262859,27
570500,229270,18461,18694,266425,20
570500,232079,18134,18264,268477,28
570500,229224,18787,18733,266744,28
570500,223712,18103,18246,260061,22
570500,222332,17990,18272,258594,24
571000,219120,17730,18272,255122,20
571000,239557,18671,18336,276564,20
571000,228544,21564,19208,269316,23
571000,228187,18142,18343,264672,30
571000,227406,18113,18460,263979,30
571500,226425,18234,18280,262939,20
571500,247450,18567,18794,284811,24
571500,228064,18198,18545,264807,26
571500,225908,18174,18381,262463,24
571500,230044,18614,18635,267293,24
572000,220505,17888,17946,256339,25
572000,253480,18633,20006,292119,26
572000,228079,18212,18305,264596,23
572000,226852,18170,18337,263359,23
572000,229851,18406,18596,266853,24
572500,228583,18662,18509,265754,23
572500,231158,18310,18297,267765,23
572500,230734,19000,18584,268318,25
572500,223931,17921,17876,259728,25
572500,234475,18803,18616,271894,23
573000,229567,18137,19018,266722,23
573000,238106,19143,19459,276708,24
573000,229073,18453,18364,265890,24
573000,225400,18243,20175,263818,25
573000,225921,18295,18320,262536,25
573500,226732,18640,18507,263879,24
573500,235033,18787,18726,272546,24
573500,227989,17951,18430,264370,23
573500,228960,18145,18207,265312,23
573500,224617,17760,17990,260367,19
574000,221924,18186,17929,258039,21
574000,242920,17982,18038,278940,21
574000,225048,18840,19475,263363,28
574000,224048,18029,18130,260207,24
574000,224755,19662,18544,262961,25
574500,231315,18578,18768,268661,25
574500,235450,18514,18598,272562,26
574500,226311,18191,18398,262900,23
574500,240127,19055,19082,278264,26
574500,233245,18992,18543,270780,26
575000,227747,18395,18902,265044,28
575000,226918,18621,18402,263941,28
575000,235142,18602,18535,272279,22
575000,234337,18420,19068,271825,30
575000,230856,18292,18356,267504,30
575500,227728,18260,18444,264432,23
575500,233500,18643,18373,270516,28
575500,233813,18793,20068,272674,23
575500,233146,18756,18697,270599,19
575500,232395,18527,19014,269936,19
576000,231625,19386,19242,270253,23
576000,242732,18416,18633,279781,26
576000,223836,17978,18152,259966,26
576000,235192,18635,18821,272648,24
576000,225267,18033,18221,261521,24
576500,224014,17963,18083,260060,22
576500,252921,19831,19147,291899,22
576500,222940,17974,18214,259128,31
576500,226195,17899,18128,262222,26
576500,223113,18160,18143,259416,25
577000,223288,18021,18101,259410,25
577000,237162,17967,18417,273546,19
577000,247094,18555,18862,284511,30
577000,229393,18336,18459,266188,23
577000,229184,17932,18175,265291,23
577500,231330,18776,18873,268979,30
577500,239410,18335,18436,276181,19
577500,227960,18647,18815,265422,20
577500,228302,18337,18421,265060,20
577500,233633,20096,21462,275191,26
578000,230667,19492,19207,269366,22
578000,249378,18362,18483,286223,22
578000,231282,18788,18584,268654,22
578000,232343,18659,19141,270143,31
578000,232482,18436,18494,269412,26
578500,234062,18348,18997,271407,29
578500,228416,18362,18484,265262,22
578500,228490,18438,18557,265485,22
578500,226283,17975,22643,266901,28
578500,223772,18799,19955,262526,21
579000,225882,17971,18248,262101,21
579000,242611,18851,18293,279755,19
579000,238034,18818,21140,277992,23
579000,261180,18555,18707,298442,22
579000,230314,18315,18470,267099,22
579500,231310,19087,19267,269664,18
579500,236050,19112,18595,273757,24
579500,235425,18676,19006,273107,24
579500,229017,18870,18508,266395,27
579500,231018,18709,18586,268313,18
580000,232697,19211,19345,271253,23
580000,242414,18561,18641,279616,23
580000,224956,18223,18554,261733,26
580000,280423,18190,18403,317016,22
580000,225531,18133,18360,262024,28
580500,225074,18116,18217,261407,28
580500,243985,18546,18444,280975,23
580500,225562,18167,18512,262241,29
580500,231733,18426,18675,268834,25
580500,230449,18409,18572,267430,23
581000,232903,18432,18567,269902,23
581000,236481,18487,21749,276717,22
581000,235294,18355,18263,271912,24
581000,237095,18415,18550,274060,22
581000,233787,20938,19646,274371,22
581500,228896,18109,18272,265277,28
581500,229655,18424,18566,266645,30
581500,229124,18486,18559,266169,27
581500,226433,18578,18367,263378,22
581500,236754,18429,18588,273771,22
582000,232396,18587,18581,269564,25
582000,230950,18511,18585,268046,27
582000,231394,18477,18590,268461,21
582000,231280,18538,18521,268339,21
582000,232675,18773,20868,272316,25
582500,234640,18918,19598,273156,22
582500,241024,18646,18646,278316,22
582500,238071,19136,18877,276084,23
582500,239973,18375,18630,276978,27
582500,235150,18535,19251,272936,25
583000,232687,18454,18911,270052,25
583000,248237,18358,18271,284866,24
583000,229941,18727,18581,267249,28
583000,240315,18863,18861,278039,22
583000,231402,18468,18599,268469,21
583500,231424,18786,18881,269091,21
583500,244371,18475,18678,281524,24
583500,230681,18509,18619,267809,26
583500,235795,18653,18656,273104,26
583500,232395,19260,19008,270663,24
584000,232011,18704,18678,269393,25
584000,240141,18808,19520,278469,28
584000,236598,18511,18678,273787,25
584000,236760,19193,19230,275183,25
584000,238283,18523,19947,276753,22
584500,237906,18840,19040,275786,20
584500,256381,18556,18720,293657,23
584500,237292,18651,19051,274994,23
584500,233869,18976,19140,271985,27
584500,231858,18547,18685,269090,26
585000,231142,18564,19424,269130,21
585000,249718,19082,19166,287966,21
585000,226187,18495,18390,263072,24
585000,227721,19502,22740,269963,27
585000,230433,18285,18390,267108,28
585500,232145,18557,18581,269283,23
585500,247499,18326,18418,284243,23
585500,238949,19025,18935,276909,25
585500,235260,19673,20199,275132,25
585500,231735,19113,19027,269875,30
586000,233940,19000,18971,271911,30
586000,237406,18630,18688,274724,31
586000,239223,19090,20403,278716,16
586000,236436,18773,18703,273912,22
586000,238701,20338,22572,281611,27
586500,235406,18713,18711,272830,27
586500,238295,21561,19455,279311,21
586500,237542,18610,18746,274898,22
586500,234167,19281,18780,272228,22
586500,234038,18789,18881,271708,22
587000,234473,18613,19372,272458,29
587000,235771,18644,18751,273166,25
587000,241511,19889,19485,280885,27
587000,231862,18642,18951,269455,23
587000,234156,18486,18493,271135,23
587500,237243,18994,19081,275318,24
587500,241445,19375,19876,280696,24
587500,233018,18624,18774,270416,19
587500,236427,19134,19231,274792,19
587500,236728,18677,18949,274354,19
588000,234017,18839,18947,271803,26
588000,239309,18721,18789,276819,26
588000,231791,18748,18770,269309,24
588000,234536,18708,18759,272003,21
588000,235966,18307,18479,272752,22
588500,243496,18955,19124,281575,22
588500,243091,18265,19344,280700,24
588500,237871,20441,19183,277495,29
588500,234021,20124,20099,274244,29
588500,240200,21458,20571,282229,20
589000,235398,18982,19127,273507,20
589000,249355,18652,18866,286873,25
589000,237713,18686,18846,275245,22
589000,234819,18850,19077,272746,31
589000,235225,18850,18844,272919,31
589500,239508,19118,20425,279051,24
589500,238564,19163,19227,276954,31
589500,234302,19155,19385,272842,21
589500,233222,18768,18841,270831,24
589500,233651,18731,18484,270866,24
590000,240514,19253,19435,279202,31
590000,236538,18780,18836,274154,25
590000,234890,18358,18542,271790,27
590000,236476,21309,19585,277370,27
590000,234877,19268,18890,273035,24
590500,234643,19493,19058,273194,24
590500,244619,18807,18937,282363,25
590500,236916,19432,19420,275768,22
590500,240203,19015,18952,278170,29
590500,240276,18709,18923,277908,29
591000,238050,18715,18845,275610,20
591000,250101,18712,18962,287775,22
591000,234668,18759,18958,272385,22
591000,234753,19064,18990,272807,22
591000,235570,19130,19245,273945,26
591500,234392,19084,19175,272651,26
591500,239997,19272,23497,282766,25
591500,234243,18787,19051,272081,22
591500,235030,19077,18872,272979,22
591500,239031,18779,18908,276718,24
592000,239410,18801,18938,277149,23
592000,253072,19326,19478,291876,22
592000,237101,18997,18895,274993,22
592000,232919,18815,18848,270582,27
592000,231785,18375,18540,268700,25
592500,231505,18426,18776,268707,25
592500,234858,18869,18891,272618,25
592500,246001,20002,19962,285965,22
592500,234596,18849,21498,274943,25
592500,236789,18775,18903,274467,24
593000,235324,18794,19231,273349,31
593000,233132,18686,18622,270440,31
593000,235773,18525,18750,273048,26
593000,241624,19213,19398,280235,26
593000,238741,19205,19289,277235,23
593500,242090,19347,19295,280732,27
593500,234462,18845,18961,272268,28
593500,239098,18977,18912,276987,28
593500,235254,21154,19323,275731,23
593500,230531,19291,18652,268474,22
594000,259168,18600,18813,296581,25
594000,234549,21915,21482,277946,25
594000,239244,20228,19531,279003,18
594000,246478,18729,18741,283948,25
594000,247338,19321,19679,286338,31
594500,235166,18847,18942,272955,20
594500,265648,19557,19374,304579,20
594500,229677,18462,18654,266793,27
594500,230641,18482,20200,269323,27
594500,231104,19062,18813,268979,26
595000,231068,18495,18743,268306,26
595000,238292,20365,19533,278190,25
595000,237408,18938,19039,275385,25
595000,237083,18538,19061,274682,27
595000,238927,19771,19458,278156,23
595500,236652,18924,18978,274554,23
595500,240469,18533,20462,279464,21
595500,247321,18679,18670,284670,20
595500,230338,20350,20702,271390,28
595500,238375,19879,19017,277271,28
596000,232425,18495,18642,269562,23
596000,245147,18859,18952,282958,25
596000,243788,20535,19178,283501,24
596000,238600,20377,21301,280278,19
596000,236884,18755,18681,274320,19
596500,233956,18546,18833,271335,28
596500,245764,18566,19071,283401,27
596500,231711,18596,18862,269169,24
596500,231782,18595,18699,269076,24
596500,238377,19236,18990,276603,20
597000,235103,19779,20604,275486,23
597000,251447,18577,18744,288768,24
597000,239427,19211,19416,278054,24
597000,236424,19542,19468,275434,23
597000,242555,18883,19051,280489,24
597500,241885,19058,19244,280187,25
597500,250773,18970,19043,288786,25
597500,238090,18924,19088,276102,24
597500,239031,19313,19992,278336,26
597500,237292,19319,19061,275672,24
598000,238139,18913,19067,276119,21
598000,247227,19026,19043,285296,21
598000,239569,18555,20291,278415,30
598000,238438,18952,19036,276426,21
598000,240315,19392,19457,279164,20
598500,240129,19214,19341,278684,20
598500,265990,19133,19052,304175,25
598500,236271,19480,21387,277138,19
598500,242851,19119,19806,281776,23
598500,241111,19381,19996,280488,23
599000,242200,19357,19101,280658,22
599000,248084,18946,19104,286134,25
599000,239658,19417,19221,278296,34
599000,240465,19125,19435,279025,19
599000,239194,19089,19087,277370,19
599500,236646,19027,19278,274951,25
599500,249687,18956,19101,287744,29
599500,243311,19573,19477,282361,33
599500,236556,18963,19112,274631,26
599500,237804,19836,19318,276958,26
600000,240081,18694,19041,277816,18
600000,234858,18716,27534,281108,17
600000,237397,19030,19105,275532,24
600000,240720,18983,19472,279175,24
600000,244024,19647,19764,283435,25
600500,231717,18781,19076,269574,22
600500,261079,19378,19051,299508,21
600500,254448,18830,19075,292353,21
600500,238316,18968,18839,276123,27
600500,252741,18636,18834,290211,24
601000,235369,111112,56222,402703,20
601000,242767,18715,18875,280357,30
601000,239187,18716,18826,276729,30
601000,239868,19049,19248,278165,21
601000,245433,19298,20203,284934,29
601500,240594,19033,19157,278784,24
601500,252633,19779,19600,292012,23
601500,242099,19591,19882,281572,28
601500,240327,19060,19278,278665,28
601500,241776,19488,19862,281126,23
602000,239549,19054,19207,277810,24
602000,248003,19221,19225,286449,21
602000,244421,19506,19697,283624,21
602000,241765,19746,19548,281059,28
602000,242723,19452,19470,281645,23
602500,241987,19113,20856,281956,24
602500,246210,19694,20154,286058,26
602500,245551,19265,19239,284055,26
602500,240197,19095,19243,278535,25
602500,241400,18864,19495,279759,26
603000,242906,19084,19205,281195,31
603000,241942,19137,19262,280341,23
603000,238322,19105,19872,277299,25
603000,237371,18801,18943,275115,25
603000,240754,19562,19708,280024,20
603500,240948,19108,19285,279341,19
603500,250715,19685,19651,290051,26
603500,241609,19148,19451,280208,26
603500,241278,19093,19237,279608,27
603500,238925,19519,19260,277704,19
604000,244243,19149,20458,283850,27
604000,247493,19199,19302,285994,32
604000,244756,19537,19786,284079,23
604000,252767,20188,21132,294087,23
604000,234531,23827,19210,277568,19
604500,243658,19488,19290,282436,25
604500,247856,19388,19256,286500,23
604500,244119,19461,19626,283206,23
604500,244470,20125,19867,284462,20
604500,241357,19576,19416,280349,22
605000,240673,19387,19306,279366,22
605000,247235,19355,19698,286288,22
605000,240790,19171,19619,279580,26
605000,240139,19319,19387,278845,26
605000,239237,19283,19784,278304,27
605500,235488,18830,19407,273725,28
605500,239771,19168,19281,278220,28
605500,242629,19175,21596,283400,20
605500,241209,19197,19321,279727,29
605500,245034,19408,19389,283831,24
606000,239741,19335,19343,278419,30
606000,244957,19736,19749,284442,24
606000,243394,19333,19563,282290,24
606000,240458,19226,19342,279026,24
606000,239400,19159,19291,277850,25
606500,243802,19585,19748,283135,26
606500,241081,19307,19374,279762,26
606500,245918,19192,19400,284510,26
606500,248461,19659,19817,287937,29
606500,236390,19082,19035,274507,21
607000,237996,18914,19158,276068,28
607000,235931,18879,19035,273845,24
607000,241297,19214,19358,279869,24
607000,241705,19223,19454,280382,16
607000,237823,18861,19160,275844,23
607500,237574,18950,19331,275855,23
607500,248996,18928,19112,287036,23
607500,241861,19514,19538,280913,26
607500,242922,19359,19920,282201,25
607500,242252,19866,19794,281912,28
608000,247033,19585,19784,286402,26
608000,247569,19515,19521,286605,26
608000,241267,19356,19370,279993,26
608000,246881,20149,19989,287019,32
608000,251499,19227,19360,290086,26
608500,241083,19279,19371,279733,16
608500,242789,20234,39049,302072,16
608500,241920,19616,20144,281680,22
608500,244311,19094,19080,282485,18
608500,247312,24456,23145,294913,21
609000,237515,19397,19201,276113,21
609000,250449,19644,19799,289892,25
609000,266686,18956,19079,304721,24
609000,243460,19284,19788,282532,28
609000,247117,19657,19600,286374,28
609500,241832,19303,19424,280559,20
609500,247858,19661,19982,287501,21
609500,243471,20020,20780,284271,25
609500,245555,19334,19628,284517,25
609500,246831,20045,20006,286882,25
610000,246111,19337,19437,284885,22
610000,247369,19790,19893,287052,26
610000,243483,19334,19696,282513,24
610000,247968,19382,19351,286701,26
610000,251733,19846,19733,291312,26
610500,249289,20144,19495,288928,26
610500,252420,19346,19510,291276,28
610500,247360,19554,19420,286334,31
610500,241610,19504,19522,280636,19
610500,241223,19011,19385,279619,28
611000,241426,19059,19442,279927,28
611000,237758,19039,19215,276012,24
611000,245927,19797,20068,285792,18
611000,247126,19385,19461,285972,24
611000,249402,19702,20033,289137,22
611500,242818,19355,19500,281673,22
611500,250191,19749,19509,289449,22
611500,244158,20026,19811,283995,30
611500,245608,19686,19887,285181,28
611500,250834,19361,19582,289777,31
612000,248147,19484,19506,287137,25
612000,255370,19773,20214,295357,25
612000,251414,19922,19874,291210,24
612000,246446,19708,19756,285910,25
612000,241870,19951,19584,281405,22
612500,245003,19796,20001,284800,24
612500,252627,19404,20230,292261,24
612500,246901,19803,20113,286817,24
612500,245971,19983,19860,285814,21
612500,247947,19590,19753,287290,26
613000,242869,19767,20274,282910,27
613000,243523,20212,20946,284681,27
613000,243414,19418,19526,282358,25
613000,238330,19127,19333,276790,22
613000,246106,19097,19203,284406,28
613500,242851,19712,19871,282434,26
613500,243610,19734,19856,283200,26
613500,245055,19567,19600,284222,21
613500,250700,19923,19635,290258,27
613500,251966,19539,19623,291128,23
614000,243048,19684,20329,283061,23
614000,263542,19568,19633,302743,23
614000,246448,19715,19775,285938,22
614000,247230,19628,19895,286753,28
614000,243641,19717,19564,282922,22
614500,248814,19428,20003,288245,26
614500,249058,19449,19589,288096,26
614500,246411,19486,19626,285523,23
614500,253053,19748,19754,292555,27
614500,245074,19566,19705,284345,26
615000,244231,19655,19632,283518,29
615000,255155,20434,20141,295730,19
615000,240036,19227,19289,278552,19
615000,254488,19785,20165,294438,24
615000,248276,21079,19962,289317,22
615500,248858,19829,20044,288731,24
615500,248379,19772,19653,287804,24
615500,247292,19472,19624,286388,26
615500,245405,19483,19845,284733,24
615500,248191,19812,19823,287826,23
616000,283888,19271,19509,322668,26
616000,239992,19205,19443,278640,26
616000,246567,19490,19647,285704,29
616000,252535,20094,20147,292776,16
616000,243975,19537,19654,283166,22
616500,244656,19537,19745,283938,22
616500,254819,19594,19716,294129,22
616500,254226,19805,19908,293939,35
616500,249418,19482,19930,288830,25
616500,245034,19561,19356,283951,21
617000,249120,19586,19730,288436,23
617000,247784,20192,19840,287816,26
617000,247912,19826,20321,288059,26
617000,245305,19884,19643,284832,22
617000,248464,19999,19999,288462,28
617500,248122,19544,19746,287412,28
617500,250427,20166,20270,290863,26
617500,246983,19738,19802,286523,26
617500,253195,20111,20392,293698,26
617500,246629,19699,19849,286177,23
618000,248857,19628,19717,288202,25
618000,269031,19635,19925,308591,27
618000,243388,19504,19552,282444,24
618000,253464,20197,20293,293954,24
618000,247745,19662,19908,287315,28
618500,251763,19605,19821,291189,22
618500,263219,19441,19539,302199,28
618500,240899,19410,19844,280153,21
618500,245519,20907,19397,285823,26
618500,252926,19401,21538,293865,26
619000,251171,19665,19874,290710,25
619000,249374,20235,19843,289452,29
619000,251592,20416,19732,291740,27
619000,247152,19297,19852,286301,23
619000,260235,19581,19488,299304,24
619500,247197,19803,20023,287023,24
619500,247027,19791,19815,286633,28
619500,252499,20075,20277,292851,29
619500,246724,21134,20822,288680,20
619500,247979,19714,19896,287589,27
620000,247150,19833,19845,286828,24
620000,251839,20623,20866,293328,24
620000,252502,19686,19744,291932,25
620000,244460,19532,19708,283700,27
620000,253725,19706,19935,293366,23
620500,253302,19660,19889,292851,27
620500,248739,19947,20152,288838,24
620500,251118,19786,20023,290927,24
620500,248144,19958,19851,287953,26
620500,252635,20938,20807,294380,24
621000,248412,19764,19795,287971,23
621000,261930,20864,20069,302863,17
621000,250206,20037,20342,290585,17
621000,252382,20407,20250,293039,27
621000,254152,20315,20647,295114,23
621500,248225,19746,19788,287759,26
621500,248629,19722,20092,288443,23
621500,244947,19549,19860,284356,23
621500,242767,19450,19589,281806,30
621500,249784,20281,19977,290042,24
622000,274016,19876,21430,315322,20
622000,252748,19768,19794,292310,20
622000,246800,19675,19850,286325,20
622000,249646,19524,19706,288876,22
622000,249293,20022,20036,289351,33
622500,249631,21910,20006,291547,24
622500,248766,19772,19923,288461,28
622500,245759,19424,19521,284704,28
622500,250500,19742,20306,290548,18
622500,247904,19738,19938,287580,20
623000,252807,20337,20270,293414,19
623000,262053,19722,19954,301729,19
623000,249029,19713,21807,290549,25
623000,251511,19773,19963,291247,20
623000,246965,19724,21587,288276,25
623500,257631,20024,20581,298236,19
623500,269987,20856,20009,310852,19
623500,250504,21185,21963,293652,26
623500,247081,20389,20431,287901,17
623500,254456,20007,20219,294682,26
624000,249113,20313,20355,289781,26
624000,257275,20537,20950,298762,24
624000,252316,19886,20007,292209,25
624000,252860,19856,20069,292785,24
624000,284845,19993,21420,326258,24
624500,249420,24662,20820,294902,27
624500,251063,20127,20222,291412,27
624500,247480,19764,19944,287188,26
624500,256313,19818,20326,296457,24
624500,248908,19836,19867,288611,18
625000,243387,19421,19561,282369,24
625000,244140,19442,19560,283142,24
625000,255646,20268,20063,295977,23
625000,256593,19888,19915,296396,20
625000,257463,21466,20299,299228,25
625500,249606,19990,19796,289392,28
625500,252223,19775,19903,291901,28
625500,252270,19921,19933,292124,30
625500,250732,19786,19939,290457,22
625500,247758,19853,19953,287564,27
626000,254402,22005,19964,296371,30
626000,251961,19812,19978,291751,19
626000,255948,21094,19941,296983,25
626000,249369,19797,20018,289184,25
626000,251708,20168,20447,292323,26
626500,255099,20152,20317,295568,23
626500,258150,19794,19925,297869,21
626500,253954,20212,20455,294621,27
626500,250137,19946,19952,290035,21
626500,250700,19953,19965,290618,21
627000,257388,20084,20050,297522,22
627000,245218,19504,19667,284389,27
627000,244290,19503,19882,283675,25
627000,294043,19635,19740,333418,25
627000,262589,19877,20141,302607,26
627500,245600,19810,20282,285692,21
627500,250447,19938,20098,290483,28
627500,254357,19825,19997,294179,24
627500,250133,19986,19978,290097,29
627500,251040,20001,19973,291014,28
628000,259778,19855,19838,299471,28
628000,244882,28947,19634,293463,25
628000,247127,19542,19672,286341,22
628000,253619,19498,19666,292783,29
628000,250927,20349,20175,291451,25
628500,259327,19963,20283,299573,24
628500,266049,19860,20122,306031,34
628500,254868,20134,20207,295209,16
628500,251599,20292,20523,292414,16
628500,253223,19913,20454,293590,29
629000,257215,19894,20021,297130,29
629000,282917,19829,19920,322666,27
629000,252226,20791,20341,293358,20
629000,245436,19819,20877,286132,20
629000,263543,20155,20455,304153,25
629500,251705,19901,20071,291677,24
629500,253793,19555,19706,293054,23
629500,246369,20963,21601,288933,23
629500,250731,19651,19749,290131,23
629500,247144,21251,21432,289827,21
630000,246776,19602,19734,286112,22
630000,246306,19649,19757,285712,24
630000,258572,19603,19776,297951,21
630000,247615,19584,19831,287030,21
630000,252491,20241,20434,293166,24
630500,255552,20347,20422,296321,21
630500,257920,20276,21660,299856,30
630500,255532,20056,20073,295661,25
630500,253667,20329,20679,294675,25
630500,257221,21215,20666,299102,19
631000,253006,20105,19870,292981,26
631000,272031,22001,22020,316052,21
631000,316264,25082,26705,368051,26
631000,250832,21195,20462,292489,27
631000,254709,19975,20124,294808,27
631500,255386,20604,20453,296443,24
631500,267707,21868,20557,310132,20
631500,255819,19969,20123,295911,28
631500,256240,19977,20119,296336,30
631500,254396,20211,20305,294912,24
632000,279977,22538,37664,340179,22
632000,270245,25255,22342,317842,22
632000,303359,24060,19972,347391,25
632000,250163,19677,19884,289724,26
632000,257544,20046,20436,298026,22
632500,257627,20262,21186,299075,20
632500,272468,20357,20196,313021,22
632500,260636,20100,20326,301062,22
632500,252857,20061,20254,293172,21
632500,257109,20420,21200,298729,27
633000,253648,23105,20639,297392,21
633000,255846,22701,24663,303210,27
633000,257652,20007,20167,297826,26
633000,259385,20126,20354,299865,26
633000,252101,19973,20121,292195,27
633500,252793,20136,23938,296867,15
633500,273562,19997,19846,313405,26
633500,247886,19847,20551,288284,25
633500,253591,20012,20124,293727,22
633500,261558,20678,20432,302668,22
634000,265186,20338,23833,309357,17
634000,278325,19980,19977,318282,20
634000,260332,20576,20560,301468,26
634000,256611,19863,19900,296374,26
634000,265572,20240,20292,306104,22
634500,252461,19842,19962,292265,29
634500,255536,19684,19828,295048,24
634500,253800,20383,20197,294380,23
634500,255707,20194,20247,296148,27
634500,254814,26034,20362,301210,26
635000,251277,20594,20095,291966,28
635000,254549,20045,20190,294784,28
635000,252893,26454,23414,302761,24
635000,253102,20108,20301,293511,19
635000,269128,20613,20917,310658,23
635500,255656,20066,20220,295942,27
635500,255293,20119,20656,296068,25
635500,254743,20115,20215,295073,25
635500,259612,20057,20065,299734,23
635500,257940,20386,20366,298692,24
636000,261726,20594,20724,303044,26
636000,297521,20256,20038,337815,18
636000,280942,19937,20312,321191,25
636000,251742,19850,20035,291627,25
636000,251250,23752,22069,297071,31
636500,258778,20143,20282,299203,25
636500,254472,20163,20297,294932,26
636500,258348,20023,20162,298533,23
636500,254689,19933,20305,294927,24
636500,253373,20152,21074,294599,26
637000,249711,19847,20048,289606,31
637000,253976,19903,21475,295354,27
637000,249642,23033,21848,294523,28
637000,252771,26578,30469,309818,23
637000,267138,21506,20588,309232,23
637500,262104,20741,21042,303887,24
637500,266671,19951,20075,306697,25
637500,266632,20726,21693,309051,22
637500,263425,20213,20367,304005,22
637500,264968,20749,21021,306738,23
638000,263481,20236,20270,303987,23
638000,264458,20157,20527,305142,28
638000,254894,20535,20583,296012,25
638000,254768,20435,20274,295477,29
638000,253884,20222,20337,294443,21
638500,252819,20497,19954,293270,24
638500,250767,20784,20358,291909,24
638500,257871,22936,19957,300764,25
638500,264122,27667,25816,317605,25
638500,255167,20069,20538,295774,30
639000,270215,19924,20881,311020,25
639000,267307,20236,20333,307876,25
639000,254200,20054,20185,294439,21
639000,251930,21714,21711,295355,27
639000,249177,19906,20323,289406,27
639500,257305,20004,20094,297403,23
639500,256515,19899,20089,296503,32
639500,257649,20211,20247,298107,31
639500,263643,20807,20730,305180,25
639500,277646,23246,20755,321647,20
640000,271703,20523,20678,312904,28
640000,257065,20630,20694,298389,30
640000,256074,20530,20824,297428,27
640000,263498,20305,20437,304240,27
640000,258667,20200,20357,299224,18
640500,261272,20386,20412,302070,22
640500,269288,20716,21560,311564,22
640500,258718,20387,20421,299526,28
640500,270631,20987,20402,312020,29
640500,255666,20336,20422,296424,23
641000,250651,20059,20172,290882,23
641000,269182,20472,20166,309820,23
641000,253135,20246,20184,293565,26
641000,257847,20318,20545,298710,24
641000,261397,20258,20393,302048,26
641500,262434,20391,20583,303408,22
641500,259763,20520,20787,301070,22
641500,256924,20358,20739,298021,24
641500,252493,20201,20188,292882,22
641500,249972,19965,20610,290547,27
642000,250922,20249,20213,291384,24
642000,313143,25485,25614,364242,24
642000,265820,20017,20175,306012,20
642000,268043,20934,23014,311991,23
642000,251191,20014,20368,291573,31
642500,251987,21741,21769,295497,22
642500,272242,23156,21852,317250,28
642500,268342,20594,20692,309628,22
642500,261551,20742,20720,303013,22
642500,254882,19944,20365,295191,22
643000,255857,19954,20271,296082,19
643000,277993,20876,22009,320878,22
643000,257874,20318,20458,298650,27
643000,262814,20471,22363,305648,26
643000,256890,21039,20549,298478,26
643500,259831,20325,20472,300628,33
643500,269028,20455,20514,309997,22
643500,257526,20686,20454,298666,20
643500,259181,20639,20638,300458,24
643500,259771,20821,20841,301433,29
644000,260465,20438,20495,301398,22
644000,282257,20055,20207,322519,22
644000,252393,20048,20283,292724,24
644000,277113,21261,21109,319483,23
644000,266710,20557,20871,308138,20
644500,254655,20052,20202,294909,23
644500,251504,20068,20224,291796,23
644500,256860,20069,20207,297136,23
644500,257352,20261,20361,297974,26
644500,276606,20113,20308,317027,26
645000,253146,20147,20303,293596,18
645000,276586,20609,20865,318060,19
645000,261482,21359,21173,304014,19
645000,259301,21368,21729,302398,25
645000,258014,20122,20270,298406,18
645500,265344,20741,20943,307028,27
645500,275375,20419,20263,316057,28
645500,256837,20445,20857,298139,28
645500,277802,25347,25463,328612,26
645500,297145,24241,24789,346175,27
646000,254143,20753,20584,295480,19
646000,276046,20169,20323,316538,20
646000,269336,21473,20428,311237,21
646000,261315,20952,22778,305045,26
646000,259077,20420,20540,300037,36
646500,259662,20540,20594,300796,26
646500,279507,20864,21396,321767,26
646500,260346,20515,20702,301563,26
646500,261912,20425,20557,302894,29
646500,264174,20412,20726,305312,23
647000,261690,20516,21313,303519,28
647000,268684,20522,20462,309668,24
647000,288540,20886,21128,330554,19
647000,262418,20584,20588,303590,25
647000,260666,21524,23497,305687,25
647500,259382,20693,21000,301075,22
647500,262828,21457,20899,305184,22
647500,266764,20395,20498,307657,23
647500,256404,23838,25169,305411,29
647500,257267,20614,20751,298632,22
648000,273859,20148,23078,317085,26
648000,258655,20278,20394,299327,26
648000,262566,20436,20332,303334,26
648000,254279,20167,20325,294771,22
648000,257072,20276,20456,297804,22
648500,269317,21591,22934,313842,27
648500,271244,20362,20422,312028,26
648500,272590,20515,20515,313620,22
648500,261525,20852,20862,303239,22
648500,266203,20680,21262,308145,21
649000,264038,20605,20689,305332,28
649000,271780,20824,26519,319123,16
649000,268344,20533,20469,309346,31
649000,263231,32635,21599,317465,27
649000,269835,20987,22005,312827,29
649500,304788,20343,20443,345574,24
649500,254892,20231,20369,295492,24
649500,255057,20223,20388,295668,17
649500,259304,20421,20646,300371,29
649500,256143,20233,20385,296761,27
650000,261993,20590,20792,303375,29
650000,262251,20683,21596,304530,30
650000,264839,21010,20901,306750,22
650000,275497,20436,22028,317961,25
650000,255036,20267,20515,295818,25
650500,261957,20669,20645,303271,21
650500,286597,21408,20382,328387,15
650500,257789,20272,20433,298494,26
650500,261090,24365,23082,308537,25
650500,254579,20303,20471,295353,25
651000,257714,20203,20456,298373,27
651000,254264,20332,20433,295029,23
651000,256462,22504,20517,299483,26
651000,265146,20807,20971,306924,26
651000,262636,21436,21139,305211,24
651500,260562,20548,20705,301815,24
651500,259181,20583,20735,300499,31
651500,261363,20582,20742,302687,24
651500,261892,20530,20698,303120,24
651500,265912,21176,21030,308118,21
652000,259350,20577,20880,300807,27
652000,264696,20882,21067,306645,24
652000,259765,20681,20727,301173,22
652000,266478,20529,20562,307569,23
652000,258643,20210,20524,299377,23
652500,255710,20340,20469,296519,21
652500,256292,20387,20488,297167,26
652500,261568,20592,21553,303713,26
652500,257235,20817,20810,298862,21
652500,261208,20651,20559,302418,26
653000,257548,24219,26480,308247,26
653000,257903,23241,20705,301849,25
653000,256836,20592,20526,297954,26
653000,267761,20406,20524,308691,27
653000,262666,20715,22813,306194,24
653500,283112,20705,20790,324607,24
653500,261571,20826,20918,303315,23
653500,260894,20477,20597,301968,24
653500,273106,20414,20495,314015,24
653500,262928,21783,21380,306091,14
654000,264889,21050,20852,306791,27
654000,282109,20643,20686,323438,23
654000,265635,21073,21267,307975,23
654000,280585,20991,25760,327336,28
654000,266980,20974,21141,309095,28
654500,256940,20391,20552,297883,23
654500,273831,20993,21140,315964,23
654500,259940,26405,20993,307338,24
654500,260126,22524,21703,304353,24
654500,260654,20581,20610,301845,30
655000,262664,20537,20566,303767,23
655000,271620,20450,20570,312640,19
655000,266322,20674,20737,307733,19
655000,267798,20605,20571,308974,26
655000,267333,20376,20726,308435,18
655500,271861,20430,20605,312896,23
655500,264120,20840,20955,305915,23
655500,263614,20729,20856,305199,27
655500,257312,21288,20866,299466,23
655500,277893,21372,21640,320905,27
656000,264195,20483,20639,305317,15
656000,287332,21552,27046,335930,22
656000,274458,20444,20660,315562,24
656000,259241,20611,20663,300515,24
656000,259848,20443,20592,300883,31
656500,271507,20432,20668,312607,22
656500,259494,23533,26612,309639,27
656500,289085,25887,26297,341269,22
656500,296840,20460,20607,337907,31
656500,266189,20468,20623,307280,21
657000,282631,20437,20903,323971,23
657000,260929,21109,20660,302698,27
657000,281197,20562,20951,322710,27
657000,257026,20452,20748,298226,27
657000,269200,20852,21194,311246,26
657500,261220,20573,20698,302491,26
657500,332549,21028,20899,374476,28
657500,298177,21899,23308,343384,23
657500,268105,20767,20931,309803,23
657500,267544,21822,21593,310959,30
658000,268386,20667,20766,309819,21
658000,264165,20537,20676,305378,30
658000,263523,20749,20737,305009,24
658000,262505,20640,20706,303851,24
658000,262704,20557,20729,303990,24
658500,291256,20902,21046,333204,24
658500,265958,20769,20887,307614,25
658500,265777,20760,20903,307440,21
658500,262284,20939,21015,304238,22
658500,263309,20991,21147,305447,29
659000,262501,20427,20703,303631,27
659000,259185,20453,20585,300223,27
659000,265011,21106,20956,307073,21
659000,264606,20583,20749,305938,21
659000,260898,20784,20695,302377,16
659500,263841,20663,20714,305218,23
659500,263857,21441,22197,307495,28
659500,263121,20540,21593,305254,28
659500,266454,20436,20683,307573,26
659500,271100,20727,21962,313789,26
660000,269366,21048,21503,311917,25
660000,264676,20930,20996,306602,23
660000,266085,21022,21166,308273,23
660000,291219,25058,21233,337510,28
660000,275390,20636,20803,316829,22
660500,266182,21369,22299,309850,26
660500,273289,21372,21070,315731,28
660500,263946,20561,21466,305973,28
660500,261849,20621,20759,303229,22
660500,272041,21045,21079,314165,27
661000,264961,20577,20763,306301,23
661000,262797,22268,21584,306649,27
661000,259260,20949,20762,300971,23
661000,259069,28566,23721,311356,19
661000,276886,20564,20712,318162,19
661500,259657,20633,20773,301063,31
661500,259854,21735,21310,302899,25
661500,260069,20692,21074,301835,21
661500,261717,22328,20566,304611,24
661500,265575,21014,21137,307726,27
662000,266670,20932,21014,308616,27
662000,283052,20944,23384,327380,26
662000,262261,20631,20789,303681,26
662000,270052,20609,20747,311408,30
662000,261097,20658,20838,302593,24
662500,266514,20998,21331,308843,25
662500,261348,20898,20809,303055,25
662500,262380,20831,20916,304127,32
662500,305696,30048,21684,357428,23
662500,264531,23299,20642,308472,27
663000,267883,21163,21416,310462,22
663000,261684,20661,20944,303289,22
663000,264728,20924,21052,306704,22
663000,267389,20910,21378,309677,23
663000,312188,23700,29613,365501,24
663500,265890,20693,22023,308606,20
663500,270634,20703,21037,312374,31
663500,288588,21085,21050,330723,23
663500,281623,20846,20834,323303,22
663500,270734,20653,23915,315302,30
664000,283074,21843,21325,326242,16
664000,289116,24936,21965,336017,16
664000,268320,20744,20870,309934,24
664000,261686,20694,20856,303236,22
664000,260713,20673,20850,302236,22
664500,274611,20796,21147,316554,27
664500,264390,20718,20858,305966,26
664500,262404,21086,21065,304555,26
664500,262089,20722,20977,303788,28
664500,261755,20666,20880,303301,21
665000,264100,21084,21455,306639,26
665000,263623,20866,20955,305444,25
665000,269164,20790,20893,310847,25
665000,262164,20728,21014,303906,28
665000,260152,21038,20945,302135,27
665500,267312,20763,21930,310005,28
665500,261878,21208,23644,306730,20
665500,346816,23772,21900,392488,20
665500,284567,27442,28418,340427,27
665500,286512,20959,20953,328424,21
666000,273456,20950,20823,315229,30
666000,262942,21537,21915,306394,18
666000,267048,21027,21187,309262,27
666000,261714,20735,20908,303357,28
666000,263462,20731,20960,305153,19
666500,261918,20760,20908,303586,19
666500,267325,21221,21145,309691,27
666500,268536,21024,21189,310749,27
666500,268766,21089,21169,311024,23
666500,277444,21692,22131,321267,30
667000,268826,22728,21284,312838,20
667000,273785,21049,21331,316165,21
667000,272000,21168,106851,400019,25
667000,268885,21138,21195,311218,22
667000,266001,20789,21129,307919,22
667500,271279,21246,21551,314076,25
667500,267166,20951,21099,309216,21
667500,272683,21659,21380,315722,21
667500,267183,21044,21180,309407,25
667500,262450,21002,23218,306670,27
668000,262168,21678,22382,306228,27
668000,265206,20934,20986,307126,28
668000,272018,21282,22145,315445,21
668000,263705,20825,20973,305503,25
668000,284938,21190,21146,327274,22
668500,272900,23245,22806,318951,27
668500,262438,20870,21331,304639,27
668500,264905,20819,20965,306689,27
668500,263677,21614,20862,306153,22
668500,279320,21215,21334,321869,22
669000,267994,21131,21270,310395,20
669000,264882,21024,20998,306904,23
669000,261798,20818,20967,303583,29
669000,265251,21994,21375,308620,24
669000,269162,20986,21060,311208,21
669500,263167,20918,21029,305114,21
669500,264207,20884,21041,306132,30
669500,265682,20884,21002,307568,23
669500,263254,20896,21428,305578,21
669500,266136,21151,21069,308356,27
670000,277481,21719,22056,321256,19
670000,283045,20843,21064,324952,22
670000,265404,20912,21087,307403,22
670000,268320,21110,21263,310693,26
670000,275811,21117,21306,318234,27
670500,267509,21187,21311,310007,25
670500,264624,21076,22205,307905,27
670500,270043,21200,21298,312541,22
670500,269062,21139,21548,311749,28
670500,308065,21159,21215,350439,24
671000,264447,21008,21055,306510,20
671000,273948,21445,21114,316507,20
671000,269330,21180,21286,311796,27
671000,263686,22047,21401,307134,23
671000,265807,20918,21111,307836,19
671500,268148,21181,21279,310608,22
671500,264158,20942,21103,306203,22
671500,265332,20943,21029,307304,22
671500,266975,21738,21444,310157,25
671500,265320,20917,21065,307302,27
672000,270544,21173,21316,313033,24
672000,265724,21406,21460,308590,22
672000,264013,20887,21215,306115,26
672000,268175,21796,21330,311301,21
672000,283669,20968,22525,327162,21
672500,271206,21245,22086,314537,23
672500,269419,21075,21412,311906,25
672500,266545,20916,21055,308516,30
672500,263360,20939,21150,305449,23
672500,265182,20918,21041,307141,25
673000,266007,25669,21219,312895,25
673000,266405,21016,21316,308737,25
673000,268002,21353,21474,310829,25
673000,265284,20946,21090,307320,25
673000,267854,20912,21207,309973,28
673500,267599,20978,21105,309682,20
673500,272797,20995,21286,315078,23
673500,265223,21013,21161,307397,23
673500,270517,21816,21570,313903,31
673500,269274,21345,21129,311748,25
674000,264336,20971,21178,306485,25
674000,268851,21790,21766,312407,26
674000,272960,21395,26409,320764,24
674000,275853,21307,21601,318761,23
674000,273334,21236,21403,315973,20
674500,320926,23495,22802,367223,19
674500,289028,22226,22795,334049,21
674500,269244,20989,21202,311435,23
674500,275073,21017,21131,317221,23
674500,267262,20967,21150,309379,22
675000,274118,21260,21424,316802,24
675000,268649,20992,21204,310845,24
675000,270781,20992,21497,313270,24
675000,267770,21039,21415,310224,19
675000,267404,21091,21189,309684,21
675500,271688,21077,21997,314762,21
675500,279812,25214,21393,326419,28
675500,267162,21027,21180,309369,29
675500,270535,21074,21166,312775,31
675500,273159,22554,22003,317716,24
676000,278794,21458,21483,321735,23
676000,267156,21077,21210,309443,27
676000,268385,21022,21155,310562,25
676000,280479,21907,21295,323681,26
676000,266305,21021,21329,308655,20
676500,273276,21050,21253,315579,20
676500,265700,21038,21306,308044,30
676500,266860,21018,21490,309368,28
676500,266787,22003,21601,310391,23
676500,267317,21072,21225,309614,23
677000,273502,21032,21166,315700,21
677000,267935,21160,21277,310372,27
677000,276729,21158,21302,319189,27
677000,265839,21091,21214,308144,27
677000,266704,21108,21236,309048,20
677500,267080,21347,21258,309685,27
677500,266691,21471,21258,309420,25
677500,268943,21430,21374,311747,28
677500,266064,21078,21249,308391,19
677500,267350,21236,21291,309877,23
678000,270023,21422,21398,312843,23
678000,342069,26211,26497,394777,23
678000,268376,21670,21381,311427,23
678000,269701,21116,21325,312142,23
678000,270135,25876,27623,323634,27
678500,265168,21116,21543,307827,26
678500,272970,21023,21228,315221,24
678500,267356,21078,21256,309690,26
678500,267129,21306,21282,309717,24
678500,271024,27601,22761,321386,27
679000,267588,21102,22946,311636,27
679000,268946,21527,21889,312362,28
679000,272514,21414,21544,315472,24
679000,273005,21417,22374,316796,22
679000,275858,21585,21524,318967,28
679500,270849,21473,21576,313898,23
679500,274847,21145,21587,317579,29
679500,268797,21064,21225,311086,22
679500,267875,21161,21299,310335,20
679500,268410,21115,21301,310826,20
680000,266709,21113,21272,309094,31
680000,275140,21106,21700,317946,24
680000,266962,21124,21372,309458,26
680000,286186,23519,21974,331679,28
680000,283496,21496,21503,326495,22
680500,289309,21620,24146,335075,32
680500,272980,23296,22754,319030,18
680500,272021,21385,21287,314693,19
680500,269230,21241,21422,311893,20
680500,278960,22649,22101,323710,20
681000,338310,26489,25616,390415,28
681000,271691,21310,21403,314404,25
681000,276379,21593,21752,319724,28
681000,272819,21092,21215,315126,22
681000,269785,21395,21323,312503,28
681500,296415,21228,21402,339045,28
681500,270098,21497,21361,312956,28
681500,271070,21864,21276,314210,31
681500,270433,21101,21454,312988,27
681500,265352,21117,21323,307792,21
682000,270787,21127,21284,313198,31
682000,272902,21295,21389,315586,23
682000,298142,21369,21507,341018,32
682000,279578,21360,21502,322440,21
682000,290281,21260,21513,333054,21
682500,269024,21246,21561,311831,24
682500,279305,21445,21477,322227,25
682500,304656,24024,22978,351658,22
682500,268852,21129,21816,311797,21
682500,283873,21722,21507,327102,23
683000,279351,21252,21441,322044,21
683000,268098,21428,21498,311024,23
683000,303822,23722,21667,349211,23
683000,268655,21156,21389,311200,25
683000,271665,21175,21375,314215,23
683500,278004,21206,21361,320571,24
683500,288167,22002,21944,332113,22
683500,269578,21696,21639,312913,25
683500,276077,21209,21364,318650,20
683500,290108,22220,22217,334545,28
684000,292405,21216,21669,335290,27
684000,289538,21243,21458,332239,24
684000,274708,21775,22000,318483,22
684000,271310,21264,21483,314057,22
684000,270783,21714,21698,314195,22
684500,270737,21280,22613,314630,19
684500,296530,21337,21457,339324,25
684500,272072,21365,21463,314900,23
684500,270752,21600,21438,313790,22
684500,276446,21968,21815,320229,28
685000,279269,26943,26926,333138,28
685000,269968,21363,22545,313876,22
685000,269848,21356,21492,312696,29
685000,272766,21265,21423,315454,29
685000,271029,21350,21496,313875,18
685500,270395,22413,21666,314474,26
685500,270333,21540,21490,313363,27
685500,279266,21580,21723,322569,22
685500,269936,21307,21463,312706,24
685500,270741,21331,21512,313584,30
686000,280521,21286,21579,323386,20
686000,285970,21320,21481,328771,20
686000,270581,21434,21484,313499,23
686000,274809,21364,21726,317899,25
686000,270849,21614,21507,313970,26
686500,278028,21351,21472,320851,26
686500,292921,21336,21511,335768,26
686500,272390,21490,27719,321599,19
686500,269442,21705,21621,312768,24
686500,275632,21282,21450,318364,24
687000,273940,21339,21630,316909,35
687000,273059,21420,21621,316100,20
687000,276635,21324,21571,319530,24
687000,274524,21635,21788,317947,21
687000,271088,21379,21528,313995,21
687500,280562,21391,21547,323500,22
687500,286542,21404,21557,329503,24
687500,280900,21398,21588,323886,26
687500,276834,21347,21503,319684,26
687500,271988,24280,26747,323015,24
688000,273539,22454,22578,318571,24
688000,270534,21383,21554,313471,25
688000,271371,21373,21898,314642,27
688000,275711,21683,21830,319224,21
688000,279771,21713,21805,323289,24
688500,335744,27034,28176,390954,28
688500,280042,22152,23779,325973,23
688500,272707,21396,21629,315732,28
688500,270049,21433,21540,313022,26
688500,269863,21447,21607,312917,26
689000,276085,21558,21790,319433,24
689000,271521,21401,21640,314562,31
689000,292888,21363,21687,335938,30
689000,277761,21462,21697,320920,21
689000,275780,21672,21736,319188,23
689500,271380,22341,22016,315737,20
689500,278363,21772,21982,322117,24
689500,281206,22038,22615,325859,27
689500,282306,21759,21886,325951,20
689500,271211,21724,21718,314653,29
690000,275025,21437,21683,318145,29
690000,279788,25283,36423,341494,21
690000,271090,21456,21584,314130,25
690000,278373,22374,22047,322794,29
690000,278745,21383,21580,321708,20
690500,285709,22126,21935,329770,27
690500,272333,21416,21691,315440,25
690500,277086,21486,22444,321016,19
690500,270823,21644,21620,314087,22
690500,271380,21511,21661,314552,20
691000,277574,21521,21642,320737,20
691000,282885,21583,21719,326187,19
691000,271702,21467,21699,314868,27
691000,274220,21468,21612,317300,23
691000,274122,21592,22128,317842,25
691500,288014,22267,22157,332438,20
691500,277121,21529,21737,320387,20
691500,275901,21441,22078,319420,22
691500,278148,21537,21672,321357,29
691500,277494,21499,21655,320648,25
692000,293554,22062,21901,337517,23
692000,280643,21636,21684,323963,21
692000,298198,21691,21778,341667,28
692000,276836,21473,21680,319989,27
692000,280060,22254,22384,324698,24
692500,279010,21811,22012,322833,27
692500,278314,21940,22254,322508,23
692500,276965,21992,21956,320913,23
692500,278461,26948,25344,330753,28
692500,283649,21860,21935,327444,22
693000,277104,21880,21966,320950,16
693000,275171,21632,21683,318486,27
693000,274085,21535,21681,317301,23
693000,272680,21702,22292,316674,22
693000,278111,21894,21849,321854,19
693500,276878,22087,21724,320689,19
693500,273240,21539,21721,316500,23
693500,274805,21568,21676,318049,19
693500,273586,21512,21679,316777,19
693500,276093,25582,23241,324916,21
694000,279845,21600,26171,327616,21
694000,274794,21549,21705,318048,24
694000,275048,21856,21746,318650,21
694000,279402,22550,22548,324500,23
694000,280094,21565,21793,323452,29
694500,278311,21674,21873,321858,29
694500,273510,21579,21738,316827,20
694500,275884,21623,24145,321652,28
694500,272898,21597,21762,316257,28
694500,272668,21555,21761,315984,28
695000,273759,21798,21742,317299,29
695000,274781,21851,21724,318356,22
695000,273536,21580,21759,316875,23
695000,281706,22100,22353,326159,25
695000,280285,22039,22942,325266,19
695500,286339,22377,27135,335851,24
695500,273983,21600,21755,317338,29
695500,273016,21602,21814,316432,22
695500,291470,22910,22234,336614,22
695500,276181,21607,21792,319580,27
696000,275398,21643,22677,319718,27
696000,274190,21591,21850,317631,28
696000,276781,22343,21778,320902,27
696000,274053,22526,21775,318354,24
696000,283262,22104,22230,327596,21
696500,283897,21952,22100,327949,25
696500,277438,22107,22010,321555,24
696500,275948,24162,22202,322312,21
696500,277629,21581,21740,320950,17
696500,275462,21634,22951,320047,17
697000,291981,21660,21862,335503,32
697000,281041,21956,22486,325483,26
697000,273661,21679,22512,317852,21
697000,284262,22054,22236,328552,23
697000,282944,22470,22275,327689,27
697500,280819,21983,22228,325030,21
697500,275161,21724,21809,318694,25
697500,285305,21683,21946,328934,22
697500,274016,21733,21878,317627,23
697500,274238,21770,21835,317843,23
698000,278005,21626,21862,321493,20
698000,275581,21660,21833,319074,27
698000,278804,21697,22059,322560,25
698000,274377,21729,21869,317975,30
698000,276398,21885,24443,322726,23
698500,287140,21965,22233,331338,27
698500,283630,21793,21863,327286,25
698500,280238,21689,21973,323900,23
698500,276303,21699,23455,321457,20
698500,301023,22436,22171,345630,20
699000,286080,21903,21930,329913,22
699000,295771,23370,21801,340942,23
699000,275018,22041,22232,319291,22
699000,277533,21746,21985,321264,22
699000,282356,23540,22364,328260,29
699500,281496,22127,22358,325981,23
699500,283195,22724,22636,328555,25
699500,282814,22012,22219,327045,27
699500,277686,22236,22540,322462,29
699500,278967,22371,22310,323648,21
700000,281942,22005,22499,326446,21
700000,283111,22253,22218,327582,22
700000,282319,22074,22168,326561,24
700000,301302,23503,21930,346735,20
700000,276839,21816,22317,320972,20
700500,278368,21734,22079,322181,26
700500,282706,23146,23336,329188,22
700500,276571,21734,21858,320163,22
700500,277836,21721,22060,321617,26
700500,276389,22562,21936,320887,23
701000,282779,22230,22342,327351,23
701000,284803,22050,21894,328747,29
701000,275374,21801,21919,319094,21
701000,277791,21782,21957,321530,28
701000,279070,21731,21982,322783,28
701500,293806,22107,22233,338146,23
701500,284475,22054,22359,328888,18
701500,282320,22516,22222,327058,19
701500,288839,22227,22239,333305,19
701500,284144,22247,22415,328806,29
702000,283030,22178,22427,327635,24
702000,282259,21970,22046,326275,30
702000,289614,22349,21939,333902,23
702000,278807,21846,21932,322585,27
702000,281799,21800,22000,325599,23
702500,281778,27532,25297,334607,26
702500,283743,21951,22064,327758,23
702500,281010,21829,21963,324802,21
702500,279394,21784,22032,323210,31
702500,280500,21885,21965,324350,30
703000,276965,21979,21990,320934,26
703000,312425,22590,21935,356950,21
703000,280568,22172,22280,325020,21
703000,279250,21802,21999,323051,20
703000,278299,21909,21997,322205,29
703500,281251,21781,22048,325080,30
703500,283520,21870,22172,327562,25
703500,283981,21993,22105,328079,23
703500,281947,21890,23097,326934,24
703500,276799,21929,21991,320719,18
704000,286627,24084,23923,334634,25
704000,278501,21816,21994,322311,24
704000,283783,25727,22073,331583,24
704000,281335,21831,22099,325265,22
704000,286881,22202,22342,331425,26
704500,279800,22247,22344,324391,22
704500,287131,22491,22696,332318,28
704500,278944,21888,22329,323161,24
704500,277990,21933,22043,321966,22
704500,281196,21937,22091,325224,23
705000,299844,21971,22084,343899,28
705000,280097,21917,22073,324087,22
705000,278294,21879,22095,322268,17
705000,283943,21850,21989,327782,17
705000,281832,21942,22117,325891,22
705500,298099,22739,22360,343198,23
705500,303752,21957,22222,347931,25
705500,300332,24796,23692,348820,25
705500,282866,21942,22166,326974,21
705500,290846,22118,22227,335191,22
706000,281950,21942,22114,326006,22
706000,303525,25842,26377,355744,26
706000,282256,21957,22137,326350,23
706000,281285,21985,22125,325395,29
706000,281099,22044,22218,325361,19
706500,278207,21923,22163,322293,21
706500,277655,22099,22141,321895,24
706500,278533,22392,22084,323009,27
706500,284476,22002,22170,328648,25
706500,281122,21932,22101,325155,29
707000,280358,22010,22173,324541,24
707000,293283,22148,22413,337844,26
707000,300662,22015,22144,344821,25
707000,284095,22243,22154,328492,22
707000,284191,21998,22207,328396,22
707500,279318,22042,22164,323524,28
707500,278848,22000,22176,323024,28
707500,279505,21990,22161,323656,25
707500,284046,25693,24605,334344,23
707500,306505,23104,24409,354018,30
708000,302138,22758,23816,348712,21
708000,325582,22470,22650,370702,25
708000,306282,22367,22629,351278,26
708000,318192,23414,22070,363676,24
708000,324336,24721,22132,371189,30
708500,299121,22300,22284,343705,23
708500,297848,22735,23715,344298,25
708500,290975,22119,22362,335456,28
708500,299129,24549,22311,345989,21
708500,284567,22056,22359,328982,27
709000,287407,22844,22813,333064,28
709000,291013,22079,22202,335294,23
709000,334002,22096,22367,378465,27
709000,283967,23235,22373,329575,28
709000,299681,22030,22306,344017,22
709500,289009,22358,22479,333846,24
709500,297762,22597,22706,343065,23
709500,284924,21963,22214,329101,25
709500,295541,23876,22510,341927,25
709500,302576,30869,25610,359055,19
710000,303061,22492,22249,347802,25
710000,300244,78883,24905,404032,25
710000,280909,22015,22175,325099,25
710000,285777,22070,24461,332308,28
710000,289377,22558,22692,334627,27
710500,287535,22484,23037,333056,26
710500,296026,27885,28253,352164,27
710500,287827,22082,22278,332187,21
710500,292854,22161,22566,337581,21
710500,297681,22854,23083,343618,25
711000,313336,28734,28763,370833,26
711000,287671,22087,22223,331981,27
711000,288776,22454,24615,335845,24
711000,287713,22509,22723,332945,23
711000,289283,22470,22604,334357,23
711500,292280,22404,22566,337250,19
711500,307043,22214,22329,351586,23
711500,289903,22242,22430,334575,21
711500,289335,29413,24806,343554,21
711500,317536,24987,24625,367148,28
712000,287853,23564,22794,334211,19
712000,301017,24496,25519,351032,23
712000,305797,22865,22766,351428,23
712000,288037,22786,22495,333318,29
712000,292815,22368,23324,338507,30
712500,302073,22518,22530,347121,21
712500,284054,22136,22406,328596,22
712500,299079,23517,22391,344987,28
712500,283871,22211,23632,329714,21
712500,290345,22596,24125,337066,29
713000,282173,22214,22336,326723,29
713000,293614,22446,22623,338683,31
713000,288108,23840,23332,335280,18
713000,296005,22478,22630,341113,28
713000,289896,22435,22682,335013,20
713500,294627,23007,22727,340361,26
713500,287657,22510,22956,333123,28
713500,287147,22796,22793,332736,27
713500,292099,28196,26471,346766,27
713500,281357,22234,22399,325990,22
714000,291705,23298,22396,337399,25
714000,293666,22208,22742,338616,26
714000,282132,22124,22356,326612,23
714000,286446,22579,22475,331500,23
714000,288061,22574,22594,333229,23
714500,292540,26415,23667,342622,27
714500,283394,26196,22718,332308,23
714500,288046,22217,22421,332684,26
714500,347649,23022,22692,393363,26
714500,327367,30954,23756,382077,25
715000,289341,23402,23947,336690,26
715000,292609,23260,23528,339397,24
715000,288073,22547,23353,333973,25
715000,288969,22604,22833,334406,26
715000,291017,22620,22670,336307,21
715500,292349,26901,22800,342050,27
715500,302681,23038,22697,348416,24
715500,296122,22801,22951,341874,19
715500,326588,22744,23623,372955,18
715500,290354,22260,22432,335046,28
716000,284343,24996,24133,333472,25
716000,310863,22696,22662,356221,25
716000,282672,22260,22468,327400,22
716000,281995,22272,22441,326708,23
716000,287465,22291,22446,332202,21
716500,288803,22257,22431,333491,25
716500,287265,22288,22453,332006,20
716500,284185,22571,22511,329267,27
716500,292661,22722,22937,338320,21
716500,289354,22593,22710,334657,22
717000,292609,23231,22486,338326,19
717000,289776,22315,22867,334958,19
717000,285199,22292,22445,329936,18
717000,287424,22616,22672,332712,22
717000,288127,26026,22967,337120,26
717500,290566,22851,22546,335963,26
717500,291879,22257,22808,336944,19
717500,285583,22318,22588,330489,31
717500,288454,22299,22536,333289,28
717500,286935,22841,27972,337748,22
718000,284578,22466,22717,329761,19
718000,311871,22493,22745,357109,19
718000,307434,22433,22516,352383,25
718000,287671,22345,22490,332506,25
718000,297878,22751,22620,343249,25
718500,295390,22985,22844,341219,25
718500,290482,23077,23316,336875,19
718500,284899,22344,22488,329731,26
718500,285823,22473,22522,330818,22
718500,290405,22605,22754,335764,25
719000,292114,23906,22880,338900,25
719000,291584,22719,22992,337295,20
719000,301107,22637,22575,346319,22
719000,295164,23393,22675,341232,22
719000,292463,22616,22554,337633,25
719500,285515,22432,22838,330785,27
719500,286196,24607,23716,334519,21
719500,290765,22737,22811,336313,27
719500,291502,22649,22824,336975,21
719500,284869,22504,22555,329928,23
720000,294008,22599,22571,339178,22
720000,290803,22619,22560,335982,27
720000,285447,23044,22549,331040,22
720000,286637,24213,22482,333332,25
720000,289098,22721,22806,334625,25
720500,291227,22388,23018,336633,20
720500,303830,22969,22845,349644,34
720500,291946,22925,22978,337849,28
720500,288394,22526,23178,334098,26
720500,298050,22948,24212,345210,27
721000,306584,22440,22914,351938,21
721000,290847,22367,22484,335698,26
721000,286260,22555,22730,331545,28
721000,300309,32513,29146,361968,23
721000,311522,30555,23553,365630,24
721500,308172,30154,24344,362670,20
721500,290265,22930,22652,335847,20
721500,295189,22860,22835,340884,21
721500,306931,22874,23296,353101,24
721500,288341,22756,22594,333691,21
722000,284896,22876,23073,330845,26
722000,287114,22484,22887,332485,22
722000,307063,23500,23009,353572,25
722000,290655,24637,22927,338219,25
722000,291639,22684,23479,337802,24
722500,305864,22510,22783,351157,27
722500,286509,22450,23030,331989,24
722500,291678,22426,22636,336740,24
722500,289142,24658,25481,339281,23
722500,307958,22715,23215,353888,23
723000,287388,23289,23247,333924,21
723000,287904,22506,25099,335509,20
723000,288009,22466,22667,333142,31
723000,287713,22467,22642,332822,21
723000,289954,22502,22723,335179,25
723500,293268,22871,23155,339294,25
723500,287891,22951,23459,334301,20
723500,289189,22657,22756,334602,25
723500,290315,22644,22711,335670,20
723500,296708,22485,23222,342415,27
724000,291106,22696,23252,337054,25
724000,287456,22493,23007,332956,29
724000,288597,22555,22666,333818,20
724000,290565,23243,22736,336544,20
724000,288651,22535,22698,333884,21
724500,292198,22534,22691,337423,25
724500,290652,22595,22721,335968,28
724500,287899,22510,22675,333084,26
724500,289898,22434,24418,336750,19
724500,289992,22544,22701,335237,21
725000,304609,22640,25282,352531,27
725000,287429,22544,22696,332669,25
725000,293937,24302,23685,341924,22
725000,290814,22557,22685,336056,23
725000,290239,22477,22753,335469,24
725500,289204,22639,22827,334670,24
725500,290133,22581,22760,335474,24
725500,298615,22579,22723,343917,18
725500,358901,28345,28297,415543,21
725500,290996,22550,22821,336367,24
726000,301500,22753,22755,347008,25
726000,286192,22611,22750,331553,16
726000,288791,22714,22748,334253,33
726000,292080,22717,23656,338453,21
726000,295362,22655,22692,340709,25
726500,289136,24002,23627,336765,20
726500,290449,22699,22818,335966,31
726500,289305,22627,22781,334713,22
726500,298042,23175,23440,344657,20
726500,292636,23285,23577,339498,22
727000,288618,22586,22750,333954,22
727000,300009,23460,23165,346634,28
727000,293521,22945,23039,339505,22
727000,294660,22535,22753,339948,25
727000,290207,22587,22764,335558,23
727500,292727,22701,22857,338285,21
727500,288018,22721,22761,333500,24
727500,287389,23122,28231,338742,24
727500,292932,22673,22757,338362,27
727500,289942,22870,22860,335672,23
728000,287940,22583,22835,333358,23
728000,309647,22655,25914,358216,28
728000,289445,22607,23930,335982,25
728000,295596,22845,22884,341325,23
728000,293508,22724,22859,339091,26
728500,289274,22673,22828,334775,21
728500,298055,23081,23256,344392,21
728500,293785,22992,23060,339837,22
728500,292448,22624,23122,338194,24
728500,295255,22978,23076,341309,28
729000,289407,22651,22753,334811,21
729000,316324,28313,28642,373279,27
729000,292809,22693,22908,338410,27
729000,303700,23716,23377,350793,26
729000,292531,22665,22672,337868,24
729500,293019,32846,23341,349206,26
729500,288671,22897,22932,334500,21
729500,291428,22674,23316,337418,22
729500,290477,22703,25413,338593,25
729500,290576,22669,22813,336058,26
730000,300610,22646,22862,346118,20
730000,291580,22936,23045,337561,24
730000,318168,24250,23104,365522,23
730000,292694,22905,22912,338511,27
730000,290236,22671,23005,335912,21
730500,291175,22736,23001,336912,21
730500,315826,23868,23805,363499,21
730500,291669,22657,23165,337491,25
730500,294589,22612,22789,339990,21
730500,290085,23329,23575,336989,19
731000,289625,22790,22911,335326,26
731000,296811,23278,23168,343257,28
731000,294656,22644,22867,340167,27
731000,290688,22871,22895,336454,22
731000,289634,22796,22966,335396,29
731500,292282,22709,22896,337887,25
731500,290035,22714,22890,335639,26
731500,289592,22767,22869,335228,25
731500,304410,23771,24091,352272,32
731500,293501,23309,23124,339934,19
732000,305503,24245,25893,355641,21
732000,297618,22780,23027,343425,20
732000,289688,22761,23206,335655,26
732000,288670,22790,22896,334356,26
732000,325966,22820,23099,371885,32
732500,303266,23052,23209,349527,23
732500,294067,22691,23438,340196,28
732500,291366,22767,22897,337030,25
732500,304191,23209,23247,350647,24
732500,290673,22758,23114,336545,26
733000,291155,39153,26777,357085,22
733000,297338,22870,22993,343201,22
733000,290719,24666,26037,341422,20
733000,296022,22744,24740,343506,27
733000,296372,22784,23001,342157,26
733500,294028,22824,23197,340049,25
733500,290893,23857,23171,337921,22
733500,292392,24434,25545,342371,23
733500,295816,22760,22969,341545,26
733500,296444,23232,23042,342718,24
734000,298522,22821,23149,344492,26
734000,290551,23172,24375,338098,22
734000,290137,22801,22986,335924,20
734000,324312,22898,23081,370291,26
734000,295231,23178,23030,341439,28
734500,293530,22763,22982,339275,21
734500,292829,22876,23082,338787,19
734500,294599,22879,22991,340469,19
734500,292141,23460,23979,339580,27
734500,309475,28183,24684,362342,26
735000,297393,22765,22992,343150,21
735000,291067,22949,23119,337135,28
735000,297807,23093,23265,344165,30
735000,292121,28916,24420,345457,33
735000,300036,23023,22967,346026,22
735500,291860,31889,32358,356107,26
735500,340371,25312,23086,388769,27
735500,306252,23798,23014,353064,20
735500,292225,22911,23126,338262,20
735500,293307,23349,24543,341199,31
736000,291756,22897,23027,337680,23
736000,294244,22884,23383,340511,22
736000,302714,23352,23331,349397,23
736000,294887,22840,22910,340637,24
736000,300996,23431,23335,347762,22
736500,304919,23647,23075,351641,26
736500,299481,23749,23513,346743,21
736500,299268,23370,26030,348668,25
736500,297399,23158,23304,343861,24
736500,297093,23187,23714,343994,20
737000,303187,22987,22949,349123,25
737000,299682,22921,23093,345696,21
737000,296399,23089,23272,342760,25
737000,293192,22900,23161,339253,20
737000,293935,23059,23301,340295,20
737500,295817,22907,23047,341771,25
737500,296526,22858,23127,342511,20
737500,293853,23035,23072,339960,21
737500,311044,22912,22994,356950,24
737500,294308,22819,23403,340530,22
738000,319043,23240,23679,365962,20
738000,317860,23693,24149,365702,22
738000,292850,22927,23124,338901,25
738000,294605,22942,23090,340637,23
738000,296272,22840,24329,343441,19
738500,292362,23248,23897,339507,19
738500,294294,24225,27239,345758,29
738500,303766,25488,25332,354586,27
738500,292996,23080,23190,339266,19
738500,335807,22964,23064,381835,29
739000,334837,22979,23179,380995,26
739000,296718,26662,27103,350483,30
739000,315070,23099,23215,361384,29
739000,292945,22946,23199,339090,24
739000,294243,22932,23100,340275,22
739500,297315,22968,23057,343340,22
739500,293505,23058,23147,339710,26
739500,299525,22941,23373,345839,25
739500,301282,23324,23619,348225,25
739500,299451,23549,23458,346458,22
740000,296187,28152,25348,349687,27
740000,301535,23567,23841,348943,26
740000,302180,23261,23407,348848,22
740000,293914,23038,23142,340094,24
740000,298003,22876,23278,344157,19
740500,294967,23607,24077,342651,23
740500,299645,22933,25189,347767,26
740500,300200,23340,24680,348220,25
740500,292991,23079,23008,339078,26
740500,301474,23717,23483,348674,21
741000,292879,22888,23068,338835,33
741000,303010,22957,23096,349063,29
741000,295862,22934,23090,341886,19
741000,291644,23398,23674,338716,28
741000,299833,23297,23537,346667,27
741500,301191,23552,23711,348454,30
741500,295106,22989,23277,341372,24
741500,299807,22960,25951,348718,20
741500,294760,23045,24818,342623,20
741500,294487,23345,23559,341391,27
742000,303460,23229,23354,350043,27
742000,374322,30486,23504,428312,19
742000,296789,23095,23245,343129,29
742000,292368,23477,23246,339091,29
742000,311864,23037,23228,358129,31
742500,297211,23032,23211,343454,24
742500,306879,23016,24931,354826,26
742500,296468,23211,23202,342881,18
742500,293562,25344,23244,342150,24
742500,297215,23047,23279,343541,17
743000,294933,23209,23318,341460,20
743000,301072,22975,23224,347271,20
743000,295452,23048,23396,341896,25
743000,298673,24854,24690,348217,23
743000,295030,23068,23291,341389,23
743500,294101,23176,23378,340655,25
743500,294356,23144,23359,340859,28
743500,307578,23843,23715,355136,20
743500,298649,23093,23241,344983,29
743500,297003,23097,23338,343438,25
744000,300271,23154,23348,346773,25
744000,301077,25883,23244,350204,23
744000,294202,23379,23823,341404,25
744000,296050,23356,23283,342689,24
744000,297338,23098,25952,346388,29
744500,300520,23072,23384,346976,31
744500,319089,23279,23278,365646,25
744500,294819,23155,23314,341288,30
744500,299778,24240,24330,348348,21
744500,296490,23115,23284,342889,22
745000,309998,23669,24574,358241,26
745000,305661,23490,23776,352927,25
745000,299304,23196,23312,345812,23
745000,320259,28378,26877,375514,24
745000,296714,23153,23344,343211,22
745500,296287,23162,23571,343020,27
745500,299363,23146,24373,346882,23
745500,295096,23156,23838,342090,24
745500,294150,23147,23412,340709,21
745500,297326,23326,23439,344091,28
746000,296679,23237,23317,343233,22
746000,300166,25129,23863,349158,29
746000,296430,25573,24139,346142,24
746000,314217,23713,23805,361735,35
746000,295878,23166,23364,342408,26
746500,298013,23230,23864,345107,23
746500,298645,23507,23812,345964,22
746500,299624,23177,23505,346306,23
746500,296414,23262,23377,343053,23
746500,296799,24626,26202,347627,24
747000,301327,23170,23355,347852,24
747000,323378,23823,23778,370979,23
747000,303623,23510,23659,350792,27
747000,303109,23807,23802,350718,24
747000,303072,24381,24849,352302,24
747500,297007,23215,23364,343586,28
747500,302307,23166,23373,348846,18
747500,302843,23159,25382,351384,18
747500,299669,23114,23549,346332,23
747500,305125,23556,23662,352343,26
748000,304024,23729,23836,351589,29
748000,307661,23546,23738,354945,23
748000,299900,23158,32118,355176,27
748000,303932,23264,23349,350545,29
748000,296607,23198,23374,343179,22
748500,368508,23122,23434,415064,27
748500,297568,23265,23439,344272,25
748500,299941,23335,23941,347217,29
748500,324275,23490,23479,371244,29
748500,305152,23659,23606,352417,24
749000,298865,23285,23573,345723,23
749000,298713,23281,23426,345420,21
749000,310777,23302,23389,357468,26
749000,307577,23290,23543,354410,23
749000,302745,23412,23973,350130,29
749500,298682,23271,24760,346713,25
749500,303982,23262,23453,350697,25
749500,304207,23244,23409,350860,26
749500,300694,23255,23998,347947,29
749500,301476,23696,23911,349083,22
750000,304875,23553,23759,352187,23
750000,305505,23923,23786,353214,32
750000,314463,23765,23754,361982,25
750000,302701,23607,23757,350065,30
750000,311261,23602,23760,358623,25
750500,302657,23881,24105,350643,21
750500,303472,23198,23852,350522,21
750500,307346,23955,25093,356394,20
750500,299009,25702,24044,348755,23
750500,299455,23314,23607,346376,24
751000,301977,24610,25335,351922,25
751000,304303,24011,23776,352090,24
751000,299569,23387,23653,346609,28
751000,300595,23692,23456,347743,22
751000,305945,23355,24997,354297,25
751500,304628,23317,24047,351992,23
751500,300933,23348,23674,347955,21
751500,304671,23866,23551,352088,33
751500,302869,23752,23774,350395,23
751500,304902,24585,24312,353799,24
752000,304616,23674,23793,352083,22
752000,304812,23914,23824,352550,23
752000,303542,23650,23764,350956,26
752000,306419,23959,23828,354206,24
752000,305780,23814,23977,353571,22
752500,303437,23896,23793,351126,24
752500,315392,23317,23420,362129,19
752500,299914,23287,23470,346671,23
752500,317452,27513,25164,370129,23
752500,299096,23286,23538,345920,18
753000,297901,23334,23532,344767,18
753000,297608,23321,23644,344573,24
753000,298192,23385,23654,345231,27
753000,303979,24679,27241,355899,26
753000,297742,23345,23532,344619,21
753500,305919,23719,23832,353470,23
753500,306455,23413,23779,353647,17
753500,313565,24022,23883,361470,24
753500,308891,23744,23955,356590,27
753500,300801,23347,23557,347705,23
754000,303355,23332,25404,352091,18
754000,305178,23672,23648,352498,25
754000,301704,23494,23514,348712,30
754000,299916,23384,24538,347838,25
754000,299151,23352,23543,346046,33
754500,306866,24719,23654,355239,24
754500,312294,23421,23653,359368,22
754500,298932,23351,23927,346210,21
754500,301246,23767,24600,349613,20
754500,355166,24173,24480,403819,24
755000,309599,24761,24205,358565,20
755000,306490,23552,24430,354472,20
755000,321789,24852,23885,370526,25
755000,300430,23983,25415,349828,24
755000,314074,23759,23905,361738,23
755500,329960,23747,23700,377407,26
755500,300629,23475,24241,348345,27
755500,310236,23766,23885,357887,21
755500,306052,23890,23798,353740,20
755500,309460,23788,24361,357609,20
756000,301919,23602,23812,349333,21
756000,312087,23906,24271,360264,17
756000,306931,23780,24007,354718,16
756000,306747,24839,23920,355506,22
756000,304989,23509,23650,352148,28
756500,310313,24529,24222,359064,28
756500,342361,23511,25886,391758,23
756500,302587,23573,23585,349745,28
756500,300924,23707,24382,349013,20
756500,326316,25994,24450,376760,21
757000,303532,23474,23620,350626,26
757000,303888,23400,23729,351017,22
757000,309397,28788,29762,367947,26
757000,309011,23564,23686,356261,26
757000,306770,23454,23700,353924,28
757500,308584,24002,24366,356952,18
757500,308381,23777,24053,356211,24
757500,317113,23717,23632,364462,19
757500,301905,28639,23728,354272,14
757500,306426,23798,24012,354236,14
758000,323516,23711,23727,370954,21
758000,302406,23590,23741,349737,25
758000,317724,23585,23809,365118,20
758000,300764,23610,23896,348270,26
758000,310358,23893,24020,358271,24
758500,310381,23822,23705,357908,20
758500,320248,28317,26417,374982,26
758500,300335,24259,23743,348337,21
758500,301280,23559,23721,348560,21
758500,307980,23590,23849,355419,21
759000,301372,23553,24455,349380,19
759000,301764,24701,23758,350223,26
759000,303124,23916,24160,351200,30
759000,310739,23840,24028,358607,27
759000,306826,23835,24357,355018,31
759500,303927,23547,24420,351894,20
759500,301681,23619,23730,349030,24
759500,310011,24172,29349,363532,18
759500,305927,23577,23781,353285,20
759500,301995,23763,24326,350084,20
760000,311997,23860,24078,359935,20
760000,312512,24367,24976,361855,22
760000,311929,24316,24044,360289,26
760000,303478,23666,23896,351040,28
760000,310099,24000,24063,358162,26
760500,302162,23909,23781,349852,29
760500,305637,23607,23822,353066,26
760500,310846,23583,23796,358225,23
760500,325948,24535,24509,374992,23
760500,305167,23724,23861,352752,25
761000,306232,24706,24302,355240,27
761000,302102,23634,24596,350332,22
761000,302957,23635,26022,352614,21
761000,303277,23665,23785,350727,25
761000,352398,26097,24710,403205,29
761500,307743,25503,24317,357563,23
761500,302302,23720,23974,349996,21
761500,328059,23914,24096,376069,29
761500,302522,23646,25398,351566,24
761500,322277,23670,23816,369763,19
762000,304116,26233,25412,355761,29
762000,317272,23657,23852,364781,20
762000,306664,23999,24231,354894,29
762000,309085,24223,24332,357640,21
762000,315032,24251,24486,363769,26
762500,313564,23935,24648,362147,21
762500,305221,23635,23846,352702,24
762500,303324,23775,23877,350976,21
762500,313244,23796,23983,361023,26
762500,308254,27526,26832,362612,32
763000,310436,23928,24421,358785,25
763000,305289,24792,23882,353963,18
763000,304249,24030,23973,352252,27
763000,311951,24467,24588,361006,20
763000,324462,23989,24560,373011,21
763500,305063,24206,23751,353020,29
763500,317846,23874,23991,365711,19
763500,306612,23775,23906,354293,22
763500,304441,24954,24132,353527,27
763500,306547,23792,23978,354317,27
764000,307573,23799,25349,356721,25
764000,310866,24153,24054,359073,22
764000,306889,23743,23884,354516,24
764000,306410,23722,23969,354101,20
764000,303991,23850,23915,351756,27
764500,334423,23724,24679,382826,22
764500,306423,23791,23909,354123,24
764500,305271,23732,23933,352936,23
764500,305281,23693,25417,354391,23
764500,312244,24595,25745,362584,20
765000,311645,24211,24644,360500,24
765000,315955,25120,23926,365001,22
765000,311487,24181,24362,360030,24
765000,306258,24477,24843,355578,22
765000,314276,24190,24406,362872,23
765500,302193,23652,24530,350375,23
765500,305639,23797,23912,353348,27
765500,303958,23686,24233,351877,25
765500,303571,23783,24278,351632,21
765500,309184,23731,23877,356792,23
766000,321434,23738,24577,369749,27
766000,303160,23712,23874,350746,22
766000,319617,24167,24661,368445,27
766000,304911,23649,23906,352466,26
766000,308464,23908,23985,356357,27
766500,308721,24234,24732,357687,26
766500,311247,23833,23934,359014,21
766500,312817,24579,24240,361636,25
766500,311913,24291,24262,360466,23
766500,310116,24094,24210,358420,22
767000,308485,23741,23940,356166,27
767000,304719,24336,24082,353137,23
767000,304029,23693,23908,351630,24
767000,313581,24170,24270,362021,25
767000,304628,23941,24070,352639,26
767500,310220,24322,24402,358944,20
767500,311139,24081,24295,359515,24
767500,326435,24718,24273,375426,23
767500,310447,23753,24133,358333,21
767500,306318,23658,24108,354084,21
768000,309322,23717,23862,356901,22
768000,323191,25102,25018,373311,26
768000,323662,24145,24352,372159,20
768000,309926,24173,23964,358063,31
768000,318564,24218,24265,367047,22
768500,305358,23935,23895,353188,24
768500,306538,23745,23999,354282,21
768500,344517,24283,24833,393633,24
768500,316298,24234,24604,365136,23
768500,304476,24109,23937,352522,30
769000,312208,25033,24322,361563,23
769000,312911,24433,24492,361836,24
769000,314489,24174,24324,362987,23
769000,311187,24258,24454,359899,29
769000,315204,24212,24365,363781,25
769500,311202,24163,24441,359806,22
769500,310550,24157,24366,359073,19
769500,308112,24422,24329,356863,27
769500,324359,24333,24505,373197,24
769500,311890,24313,24318,360521,25
770000,312408,24736,24357,361501,28
770000,312896,24164,24389,361449,24
770000,311625,24229,24558,360412,24
770000,313131,24226,24363,361720,26
770000,309948,24414,24670,359032,26
770500,312103,24207,24376,360686,20
770500,326955,24275,24471,375701,20
770500,316909,24189,24259,365357,20
770500,307508,23892,24040,355440,26
770500,318124,24178,24351,366653,23
771000,307806,24749,24574,357129,17
771000,305727,24003,25185,354915,24
771000,330897,24404,24583,379884,22
771000,311405,24217,24495,360117,29
771000,311630,24286,24452,360368,22
771500,306324,24034,23978,354336,24
771500,329771,24474,25048,379293,20
771500,319862,24382,24570,368814,26
771500,315956,24236,24930,365122,22
771500,317328,24228,24461,366017,22
772000,318369,24589,24736,367694,20
772000,313192,24297,24403,361892,24
772000,330915,23745,23955,378615,28
772000,306407,24605,26534,357546,21
772000,311764,24020,24195,359979,22
772500,311300,24662,24027,359989,24
772500,306464,28417,25311,360192,23
772500,307679,24053,24209,355941,21
772500,307780,23923,24446,356149,22
772500,313244,31790,31247,376281,24
773000,354320,31261,28045,413626,25
773000,317635,30921,28773,377329,23
773000,310118,23969,24108,358195,22
773000,355422,23906,24095,403423,24
773000,318903,37195,24669,380767,22
773500,317869,24064,24111,366044,23
773500,315123,24307,24454,363884,32
773500,317087,24681,24429,366197,25
773500,309498,23992,24058,357548,15
773500,318913,24580,24905,368398,26
774000,320112,23962,24134,368208,22
774000,324140,23924,23983,372047,30
774000,316047,24491,24625,365163,29
774000,317808,24742,24660,367210,20
774000,313819,24298,24923,363040,26
774500,306975,25651,24836,357462,25
774500,314073,24442,24507,363022,22
774500,312618,24804,24924,362346,26
774500,306855,23819,24074,354748,21
774500,306613,23890,24029,354532,25
775000,312722,24176,24041,360939,22
775000,310468,24032,24102,358602,22
775000,309766,24432,24156,358354,25
775000,315705,24322,24758,364785,21
775000,340093,24370,24525,388988,21
775500,313656,23879,24080,361615,25
775500,307947,23935,24177,356059,29
775500,307581,25355,24038,356974,26
775500,314899,23830,25013,363742,23
775500,315637,25746,24913,366296,22
776000,316989,25515,24891,367395,23
776000,333630,24583,24623,382836,18
776000,317009,24973,25312,367294,21
776000,318572,24903,24322,367797,21
776000,311769,24214,24481,360464,24
776500,314755,24456,24333,363544,23
776500,308639,24236,24275,357150,25
776500,316678,24370,24645,365693,20
776500,317676,24439,25003,367118,27
776500,322486,24408,24537,371431,22
777000,315814,24759,24609,365182,21
777000,376856,24139,24400,425395,23
777000,320326,24469,24791,369586,16
777000,330604,24206,24486,379296,23
777000,314854,25975,24933,365762,22
777500,308705,25318,30985,365008,26
777500,315127,24439,24611,364177,26
777500,309559,24048,24106,357713,25
777500,317804,24944,24766,367514,20
777500,326500,24696,24441,375637,22
778000,316731,24576,24807,366114,15
778000,308966,24104,24189,357259,26
778000,310762,26115,24253,361130,25
778000,317052,24401,24603,366056,24
778000,318921,25252,25094,369267,27
778500,335600,24576,24816,384992,27
778500,316153,24454,24618,365225,22
778500,315410,24665,25108,365183,27
778500,317611,25301,24783,367695,24
778500,312541,23993,24528,361062,25
779000,311230,26586,25291,363107,26
779000,309051,24073,24266,357390,27
779000,317691,26293,28859,372843,22
779000,309515,24049,24192,357756,21
779000,308851,24057,24238,357146,22
779500,324476,24702,24943,374121,23
779500,320335,25235,24693,370263,25
779500,318815,24703,24894,368412,23
779500,318586,25091,25234,368911,22
779500,321322,24622,24627,370571,31
780000,319853,24632,25058,369543,18
780000,318729,26120,24954,369803,28
780000,330004,24542,24656,379202,21
780000,316686,24681,25051,366418,28
780000,316287,24491,24723,365501,16
780500,320405,24656,24737,369798,25
780500,312837,24312,24216,361365,25
780500,328674,24326,24356,377356,22
780500,309704,24116,24341,358161,24
780500,318730,25253,24859,368842,19
781000,331074,28330,24547,383951,20
781000,319385,24535,28677,372597,21
781000,311764,24188,24331,360283,21
781000,319608,24128,24332,368068,20
781000,312704,24797,24284,361785,28
781500,316196,25108,25945,367249,25
781500,320652,35551,26251,382454,18
781500,316724,24716,24408,365848,20
781500,332661,24966,26130,383757,23
781500,309506,24325,24431,358262,22
782000,310460,24190,24373,359023,22
782000,317115,24322,24381,365818,27
782000,315177,26249,24257,365683,27
782000,312384,24883,24490,361757,20
782000,310576,24180,24611,359367,20
782500,311604,24196,24460,360260,26
782500,310388,24213,24388,358989,20
782500,311599,24296,24394,360289,21
782500,310424,24286,24389,359099,26
782500,316503,24572,25058,366133,28
783000,311012,24157,24387,359556,23
783000,314548,24232,24390,363170,21
783000,311414,24198,24370,359982,21
783000,349600,28037,29679,407316,27
783000,312877,24190,24445,361512,26
783500,329652,25451,24494,379597,25
783500,310736,24217,24633,359586,19
783500,312174,24272,24392,360838,19
783500,312762,24814,24422,361998,26
783500,312839,24311,24421,361571,31
784000,311961,25479,24458,361898,19
784000,311610,24298,24476,360384,19
784000,313453,24730,24480,362663,30
784000,323428,24864,24977,373269,26
784000,319743,26067,24986,370796,24
784500,314065,24782,25532,364379,20
784500,334032,24634,24778,383444,33
784500,321468,24751,24925,371144,23
784500,310967,24279,24427,359673,26
784500,313508,24295,24630,362433,24
785000,317685,24219,24957,366861,23
785000,311708,25153,24634,361495,28
785000,319323,27017,27214,373554,26
785000,314633,24277,24534,363444,31
785000,315367,24283,24483,364133,29
785500,311927,24307,24479,360713,26
785500,317021,25780,24561,367362,18
785500,314733,24518,24609,363860,29
785500,320519,24888,25022,370429,20
785500,317405,24693,24835,366933,21
786000,335781,24228,24481,384490,24
786000,315328,24415,24515,364258,21
786000,330528,24480,24506,379514,27
786000,324264,24511,24456,373231,22
786000,350619,24391,24554,399564,23
786500,321203,24456,24691,370350,24
786500,325928,25200,25717,376845,25
786500,317493,25465,24938,367896,24
786500,324240,25218,25663,375121,26
786500,318218,24727,24796,367741,29
787000,329656,26379,24694,380729,26
787000,315297,24352,24663,364312,19
787000,333852,24470,24643,382965,20
787000,314250,24910,25049,364209,25
787000,340269,24514,24651,389434,22
787500,325533,24405,24559,374497,21
787500,318194,24422,24927,367543,19
787500,314845,24440,26221,365506,19
787500,318758,25110,24551,368419,26
787500,328276,25142,25306,378724,26
788000,315921,25135,24695,365751,23
788000,316532,24833,24708,366073,23
788000,315355,26725,27823,369903,22
788000,345317,26196,27447,398960,22
788000,318277,24521,24611,367409,26
788500,324353,25066,24683,374102,25
788500,345971,25295,25282,396548,23
788500,323672,24856,24925,373453,28
788500,321651,24802,25021,371474,24
788500,322996,25135,26557,374688,20
789000,322461,24804,24958,372223,18
789000,332231,25406,25028,382665,21
789000,325476,29904,24952,380332,27
789000,343577,29576,27386,400539,26
789000,322387,24818,24849,372054,25
789500,322212,24513,43462,390187,23
789500,338907,24720,24938,388565,22
789500,336192,27000,26683,389875,25
789500,339586,24943,25226,389755,20
789500,317374,24702,24705,366781,21
790000,326076,24541,24709,375326,21
790000,317396,24977,24744,367117,30
790000,326875,25254,25159,377288,23
790000,317697,24842,24732,367271,23
790000,331452,25875,25783,383110,21
790500,324015,24806,24999,373820,27
790500,328907,25573,26186,380666,18
790500,326724,24900,25045,376669,22
790500,323067,24845,25020,372932,22
790500,323018,24969,25566,373553,19
791000,325643,24980,25475,376098,26
791000,321229,24928,24967,371124,23
791000,316505,24470,24575,365550,18
791000,319070,24588,24573,368231,25
791000,318555,24489,24649,367693,22
791500,319643,24453,24738,368834,26
791500,316537,24453,24928,365918,26
791500,318423,24500,24649,367572,22
791500,322992,24485,24631,372108,22
791500,316362,24522,24726,365610,20
792000,316466,24452,24782,365700,27
792000,318072,24485,24685,367242,26
792000,315082,24488,24885,364455,22
792000,314300,26494,28973,369767,25
792000,315085,24540,24674,364299,26
792500,371040,24585,31254,426879,21
792500,321967,24487,24628,371082,25
792500,326914,25024,25186,377124,25
792500,321263,24913,25253,371429,24
792500,330460,25014,25073,380547,21
793000,316214,24714,24826,365754,28
793000,340283,25344,24716,390343,25
793000,335120,24919,25106,385145,19
793000,332290,24648,24868,381806,23
793000,318802,24618,24704,368124,27
793500,329808,24554,24810,379172,24
793500,319743,25682,26278,371703,22
793500,359039,24924,25430,409393,27
793500,327330,24573,24956,376859,22
793500,322195,26154,24959,373308,19
794000,317385,26512,26762,370659,24
794000,321527,24853,25179,371559,17
794000,326671,25051,25164,376886,25
794000,319950,25473,24664,370087,25
794000,343513,25178,25706,394397,22
794500,316290,24527,24778,365595,23
794500,324355,25585,25520,375460,20
794500,322248,25451,25323,373022,19
794500,320371,24616,25017,370004,27
794500,323985,25417,24674,374076,20
795000,352157,25220,25434,402811,23
795000,328132,25602,25258,378992,23
795000,324902,25140,25255,375297,29
795000,325169,25245,25112,375526,17
795000,322131,24890,27959,374980,26
795500,330154,25162,24878,380194,23
795500,366987,25308,25102,417397,23
795500,319811,24910,24947,369668,22
795500,321815,24964,25064,371843,22
795500,317831,24554,24747,367132,24
796000,322036,25499,25170,372705,20
796000,322573,24535,24752,371860,26
796000,342977,24678,24831,392486,23
796000,334044,25160,25343,384547,23
796000,332837,25511,26139,384487,24
796500,329489,27139,26238,382866,21
796500,324856,24955,24996,374807,17
796500,329115,26835,26344,382294,24
796500,358482,24877,24971,408330,26
796500,329431,24976,25036,379443,27
797000,325874,24599,25172,375645,27
797000,375745,26431,29635,431811,23
797000,353219,25948,33261,412428,25
797000,354795,25245,25094,405134,24
797000,319992,24942,25064,369998,20
797500,329173,25396,25486,380055,26
797500,324088,25039,25250,374377,20
797500,355339,34069,26868,416276,25
797500,346588,24791,25186,396565,22
797500,345025,25117,25540,395682,27
798000,327551,24748,25407,377706,18
798000,328800,25078,25309,379187,25
798000,321900,24740,24944,371584,18
798000,331861,24818,24981,381660,24
798000,320299,24872,24940,370111,22
798500,343373,28704,27998,400075,17
798500,336729,25720,27843,390292,25
798500,328207,24809,25190,378206,18
798500,325732,25835,25636,377203,19
798500,320699,25141,25376,371216,30
799000,325597,24799,25032,375428,24
799000,324735,28657,25403,378795,29
799000,328445,25643,25479,379567,22
799000,327455,25541,25604,378600,30
799000,326356,26088,25978,378422,14
799500,325483,25609,25506,376598,26
799500,332356,25381,25308,383045,27
799500,321667,24798,25037,371502,24
799500,324944,25410,25846,376200,22
799500,323332,25954,26163,375449,28
800000,319712,24903,25506,370121,23
800000,319350,24837,25249,369436,19
800000,328618,25235,25275,379128,28
800000,327683,24784,25050,377517,22
800000,335212,26052,25475,386739,25
800500,331002,26302,25561,382865,28
800500,327121,25008,24983,377112,26
800500,347235,25456,26126,398817,22
800500,327772,25516,25655,378943,28
800500,328346,25156,25505,379007,24
801000,329511,25819,25728,381058,25
801000,336183,25540,25390,387113,21
801000,340778,25575,25609,391962,20
801000,330016,25130,25358,380504,25
801000,329290,25130,25354,379774,17
801500,324496,24897,24914,374307,22
801500,368310,24830,25082,418222,22
801500,326907,24906,25351,377164,25
801500,329408,24747,24989,379144,29
801500,326883,25296,25882,378061,19
802000,329896,25158,25421,380475,23
802000,328760,24795,25041,378596,24
802000,330696,26399,27968,385063,24
802000,330773,25181,25335,381289,29
802000,328732,24896,25353,378981,30
802500,323295,24929,25058,373282,20
802500,321831,34137,37110,393078,20
802500,320328,25034,25107,370469,20
802500,322412,26675,26655,375742,25
802500,332810,26090,26300,385200,24
803000,356989,25853,26127,408969,29
803000,336581,25268,25299,387148,29
803000,322365,25195,25520,373080,25
803000,322339,25386,25211,372936,23
803000,321284,25149,25978,372411,21
803500,322909,24928,25122,372959,20
803500,328490,24978,25133,378601,29
803500,324007,24925,25084,374016,26
803500,322874,25098,25142,373114,17
803500,337306,24881,25170,387357,23
804000,344309,25928,27041,397278,21
804000,326756,25895,25288,377939,26
804000,322969,24946,25123,373038,22
804000,346625,25479,25504,397608,30
804000,327008,25274,25792,378074,28
804500,320603,24969,25578,371150,20
804500,329648,32260,33236,395144,23
804500,327139,38414,36599,402152,26
804500,341627,24956,25190,391773,23
804500,324160,24966,25210,374336,31
805000,324751,25236,26404,376391,23
805000,325220,25073,25380,375673,23
805000,336206,26301,26381,388888,27
805000,324207,25281,25148,374636,29
805000,322189,25213,25129,372531,25
805500,324236,25050,25168,374454,22
805500,329376,25017,25171,379564,29
805500,341230,33249,25331,399810,23
805500,349706,26292,25929,401927,26
805500,320443,24930,25093,370466,23
806000,327944,25517,25193,378654,24
806000,324605,24999,26107,375711,28
806000,329453,24996,25778,380227,22
806000,339191,25149,25214,389554,24
806000,321861,25538,25714,373113,20
806500,327715,26766,25037,379518,26
806500,326583,25386,25566,377535,26
806500,321971,25091,25219,372281,23
806500,331487,25692,26257,383436,25
806500,324752,24972,25189,374913,25
807000,329522,26515,26699,382736,26
807000,329118,25046,25806,379970,23
807000,323008,27785,25515,376308,22
807000,326340,25021,25246,376607,26
807000,330800,26486,25300,382586,22
807500,328957,27510,32369,388836,24
807500,323225,25078,25299,373602,23
807500,325689,25175,25215,376079,27
807500,327047,25123,25392,377562,24
807500,333828,25261,25210,384299,28
808000,335938,25100,25273,386311,30
808000,327551,26455,26100,380106,20
808000,323221,27097,32537,382855,24
808000,324791,25150,25239,375180,27
808000,327786,25340,25333,378459,18
808500,328773,25364,25303,379440,27
808500,324774,25125,27327,377226,21
808500,334203,28129,27015,389347,19
808500,333755,25340,25773,384868,26
808500,327801,25093,25269,378163,20
809000,325431,25109,25674,376214,22
809000,327112,25120,25283,377515,22
809000,336878,25115,25230,387223,22
809000,326234,25246,25337,376817,24
809000,332541,26372,25903,384816,26
809500,326712,25223,25366,377301,26
809500,330002,26115,25942,382059,25
809500,329115,25995,25624,380734,21
809500,328408,25102,25312,378822,20
809500,324382,25125,25305,374812,24
810000,329802,25092,25311,380205,26
810000,353281,25970,25404,404655,19
810000,334944,25588,25602,386134,19
810000,332411,25172,25368,382951,25
810000,324834,25272,25305,375411,26
810500,385999,25727,31142,442868,21
810500,328025,25179,25319,378523,28
810500,336536,25225,25342,387103,25
810500,360331,25355,25320,411006,23
810500,355796,25164,25414,406374,29
811000,325436,25117,25331,375884,29
811000,326096,25125,25344,376565,20
811000,325452,25141,25616,376209,21
811000,348969,25448,25648,400065,21
811000,333405,25502,25609,384516,23
811500,336396,25581,25649,387626,30
811500,332184,26335,26525,385044,23
811500,337495,25615,27292,390402,21
811500,325554,25714,26071,377339,27
811500,346329,25572,25607,397508,26
812000,327504,26257,25579,379340,30
812000,328044,26637,25704,380385,23
812000,325712,26212,25224,377148,23
812000,329106,25482,25639,380227,25
812000,326421,30513,26027,382961,23
812500,335239,25345,25360,385944,22
812500,325481,25449,25524,376454,25
812500,334585,25486,25419,385490,24
812500,325609,25337,25379,376325,26
812500,332803,25189,25343,383335,22
813000,325784,25603,25780,377167,28
813000,327512,26040,27174,380726,27
813000,329028,25248,25405,379681,21
813000,358829,25704,25351,409884,19
813000,332066,25381,26120,383567,19
813500,349125,27726,25220,402071,26
813500,342600,25326,25757,393683,23
813500,347238,25076,25403,397717,21
813500,325379,25308,25508,376195,21
813500,324680,25422,25834,375936,20
814000,330093,25661,25917,381671,20
814000,326715,25482,25604,377801,23
814000,326944,27852,26065,380861,22
814000,328904,25268,25464,379636,24
814000,330354,25268,25418,381040,24
814500,327369,25959,25407,378735,28
814500,326302,26061,25661,378024,22
814500,340927,25408,25546,391881,22
814500,344294,25338,25838,395470,24
814500,326037,25267,25456,376760,27
815000,328658,25278,25516,379452,22
815000,340169,25708,25895,391772,30
815000,326260,27796,27232,381288,25
815000,357777,25455,28856,412088,29
815000,325748,25411,25775,376934,22
815500,325836,25344,26297,377477,26
815500,327013,25485,25509,378007,25
815500,326759,25308,25473,377540,23
815500,345249,25388,25474,396111,26
815500,331573,25583,25577,382733,22
816000,342701,25272,26014,393987,27
816000,353915,25912,25731,405558,21
816000,332008,26093,25649,383750,27
816000,330189,25681,26821,382691,23
816000,350535,25322,25492,401349,22
816500,326888,25262,26221,378371,21
816500,333811,25275,27051,386137,24
816500,343984,33305,33912,411201,19
816500,334658,26518,25972,387148,29
816500,339583,26245,26257,392085,25
817000,340942,26833,26010,393785,22
817000,338526,25747,25895,390168,23
817000,367796,27916,26081,421793,23
817000,356850,29788,29387,416025,28
817000,337042,25400,25781,388223,21
817500,353491,25525,27080,406096,26
817500,335687,25407,25593,386687,30
817500,347658,25453,25604,398715,24
817500,325948,25901,25430,377279,19
817500,328716,25339,25512,379567,22
818000,331352,25398,25466,382216,22
818000,350665,27426,26591,404682,24
818000,328162,25520,25555,379237,23
818000,386321,26275,25917,438513,21
818000,332841,25309,25667,383817,25
818500,328384,25653,25667,379704,23
818500,325645,25344,25548,376537,25
818500,341197,26567,26442,394206,25
818500,329023,25749,25438,380210,25
818500,333115,25419,25596,384130,26
819000,334319,25310,25520,385149,26
819000,336710,26876,27098,390684,23
819000,330226,25313,25489,381028,23
819000,357365,31953,31963,421281,23
819000,343488,25315,27397,396200,17
819500,333134,25397,25811,384342,13
819500,327799,25731,25560,379090,22
819500,338359,25296,25549,389204,19
819500,327425,25338,25677,378440,19
819500,326793,25327,25691,377811,27
820000,334531,26778,25555,386864,24
820000,359016,25764,25893,410673,26
820000,345569,25945,26369,397883,27
820000,335635,25304,25429,386368,28
820000,331739,25370,28507,385616,26
820500,335251,25918,26102,387271,27
820500,333573,25795,25976,385344,29
820500,331341,25318,25488,382147,27
820500,337964,26566,25910,390440,23
820500,352157,25475,25795,403427,17
821000,345276,26066,26133,397475,27
821000,334870,25281,25470,385621,29
821000,329845,25403,25551,380799,28
821000,330409,25901,26026,382336,24
821000,330536,25902,26258,382696,27
821500,336263,26210,26260,388733,27
821500,332094,25312,25540,382946,17
821500,327131,25323,25546,378000,17
821500,329754,25453,25551,380758,23
821500,357372,26511,26041,409924,23
822000,337017,25870,25945,388832,29
822000,334833,26158,25963,386954,20
822000,337713,26357,26220,390290,22
822000,357608,26801,27069,411478,30
822000,356993,27635,26613,411241,31
822500,359230,25885,25828,410943,18
822500,333324,25491,25706,384521,20
822500,352120,25837,26047,404004,28
822500,336551,25674,25822,388047,26
822500,341024,29167,27823,398014,28
823000,329592,27794,30232,387618,21
823000,358332,36918,33906,429156,16
823000,415074,26825,30343,472242,24
823000,332195,25725,25781,383701,29
823000,337097,25879,25975,388951,25
823500,336582,26046,26328,388956,28
823500,335558,25823,26174,387555,18
823500,337788,25576,25741,389105,25
823500,332252,25739,25856,383847,25
823500,338651,27227,26394,392272,26
824000,361800,30277,31909,423986,29
824000,356388,25776,25925,408089,24
824000,350741,26955,27397,405093,21
824000,339068,32361,31607,403036,35
824000,330597,25426,25638,381661,19
824500,338342,26092,26912,391346,17
824500,331295,26009,25839,383143,22
824500,329203,25402,25602,380207,22
824500,331977,25400,25657,383034,25
824500,330950,25609,26113,382672,27
825000,336499,25859,26193,388551,27
825000,334525,25759,25747,386031,27
825000,356508,27529,27316,411353,28
825000,336416,25501,25674,387591,20
825000,339165,27276,26183,392624,19
825500,335896,25984,26070,387950,22
825500,343224,28291,26278,397793,20
825500,335240,25913,25996,387149,21
825500,402028,27447,28794,458269,20
825500,357765,26186,26752,410703,29
826000,336422,26514,25944,388880,21
826000,338124,29468,30824,398416,21
826000,347086,26303,26214,399603,22
826000,341295,26742,26111,394148,23
826000,340454,26154,28034,394642,27
826500,330923,25824,26000,382747,26
826500,363395,25760,25902,415057,24
826500,362088,25693,25821,413602,31
826500,342432,27531,28238,398201,17
826500,345771,25925,26983,398679,25
827000,334196,26763,27539,388498,21
827000,360789,29686,29088,419563,24
827000,336616,25866,26970,389452,21
827000,347047,26505,26143,399695,26
827000,354604,25656,26653,406913,29
827500,347706,26229,26610,400545,23
827500,339075,26477,26270,391822,21
827500,337678,25959,26679,390316,19
827500,341389,26195,26956,394540,21
827500,338833,25947,26102,390882,26
828000,341256,26481,33814,401551,22
828000,335997,26674,26615,389286,29
828000,343973,25709,26475,396157,25
828000,333153,25638,25789,384580,24
828000,346422,26090,25795,398307,21
828500,340671,26186,26150,393007,23
828500,344353,26156,26392,396901,28
828500,340134,26056,26149,392339,22
828500,338979,26017,26124,391120,22
828500,342366,25972,26259,394597,25
829000,349603,25625,25804,401032,23
829000,331192,25676,25933,382801,21
829000,348164,25614,30443,404221,24
829000,340310,25974,26258,392542,26
829000,342459,26080,26375,394914,30
829500,352083,26261,26331,404675,22
829500,347200,25820,25935,398955,22
829500,339469,26051,26817,392337,27
829500,341729,25978,26220,393927,26
829500,333426,25701,25936,385063,21
830000,340519,25733,26122,392374,26
830000,350443,26481,26627,403551,27
830000,333860,25824,26087,385771,24
830000,344386,25815,26638,396839,24
830000,370680,27014,27430,425124,23
830500,357325,25689,26007,409021,20
830500,334459,25866,25937,386262,21
830500,336887,25911,27131,389929,24
830500,338047,26313,26363,390723,19
830500,381009,26243,28475,435727,27
831000,347198,26124,26572,399894,25
831000,341970,26291,26633,394894,26
831000,343424,25919,26029,395372,28
831000,348897,26566,26453,401916,26
831000,335455,25715,25844,387014,30
831500,344942,25747,25840,396529,25
831500,333184,25991,26509,385684,25
831500,337598,25834,25941,389373,18
831500,400642,33889,28386,462917,23
831500,350190,26630,26904,403724,27
832000,354358,26338,26342,407038,21
832000,378169,26218,30480,434867,27
832000,344524,26801,27196,398521,28
832000,343377,26069,25994,395440,24
832000,338056,26195,26615,390866,28
832500,339493,26121,26659,392273,28
832500,339302,26072,26274,391648,19
832500,331349,25663,25983,382995,23
832500,340696,27045,27823,395564,29
832500,333224,26057,25945,385226,22
833000,375437,31462,36342,443241,26
833000,359159,25688,25938,410785,27
833000,341683,25881,26132,393696,28
833000,353534,25807,25916,405257,24
833000,370663,26419,26828,423910,25
833500,344302,26162,26096,396560,25
833500,449421,26302,26781,502504,26
833500,348484,30048,33984,412516,26
833500,337285,26236,26133,389654,26
833500,387472,26781,27848,442101,22
834000,367221,38829,32006,438056,28
834000,354805,27423,29093,411321,21
834000,364923,26287,27009,418219,24
834000,361460,26428,26876,414764,20
834000,375209,27698,29295,432202,28
834500,360276,25907,28825,415008,23
834500,344632,27485,26515,398632,30
834500,351760,34293,26767,412820,27
834500,345947,26216,27107,399270,28
834500,345129,26536,27462,399127,24
835000,344921,26178,26469,397568,13
835000,348815,26814,26631,402260,21
835000,343366,26238,26339,395943,24
835000,347010,27367,26652,401029,23
835000,351566,26461,26566,404593,24
835500,345734,26580,26744,399058,21
835500,342840,27386,27179,397405,25
835500,343898,26670,26488,397056,23
835500,346741,27011,26418,400170,27
835500,347647,26783,26847,401277,22
836000,347189,26835,27249,401273,28
836000,344812,26584,26475,397871,26
836000,351769,26713,26917,405399,29
836000,344748,27264,27394,399406,25
836000,354254,26782,26769,407805,21
836500,352802,26765,27012,406579,23
836500,352726,26793,27307,406826,20
836500,361279,26563,26142,413984,29
836500,349149,27440,26970,403559,29
836500,348467,27156,27330,402953,23
837000,346809,27226,27035,401070,22
837000,347297,26351,26603,400251,28
837000,348564,26866,27358,402788,24
837000,345504,26746,27143,399393,24
837000,344886,26849,26737,398472,23
837500,348536,28572,29258,406366,24
837500,348464,26971,26444,401879,21
837500,349375,26453,26656,402484,23
837500,343987,26296,26426,396709,22
837500,341181,26177,26204,393562,22
838000,374119,26773,27135,428027,23
838000,344786,26010,26099,396895,23
838000,364355,33024,27871,425250,21
838000,342727,31871,33545,408143,24
838000,357485,25875,26266,409626,23
838500,343193,28459,26825,398477,26
838500,341664,26155,26862,394681,25
838500,347037,28110,29429,404576,21
838500,337550,25853,26023,389426,24
838500,341241,31704,38774,411719,19
839000,341787,25981,26399,394167,21
839000,344446,26227,27433,398106,21
839000,334516,26035,26775,387326,18
839000,342385,26235,26148,394768,28
839000,345788,26021,26316,398125,26
839500,335823,25993,26132,387948,20
839500,336943,28401,26485,391829,24
839500,350173,27736,27475,405384,24
839500,337836,25832,26148,389816,25
839500,337747,26234,26312,390293,26
840000,338039,27476,26573,392088,25
840000,365213,26303,42431,433947,22
840000,337158,25868,26097,389123,19
840000,336259,26519,26572,389350,22
840000,338780,26078,26247,391105,25
840500,334453,26199,27409,388061,22
840500,338977,25935,26160,391072,26
840500,340664,25951,26134,392749,25
840500,342676,25865,26014,394555,28
840500,343979,26570,26513,397062,26
841000,346464,26605,26538,399607,25
841000,337964,25910,26052,389926,27
841000,359519,29145,28351,417015,22
841000,342013,26099,26366,394478,26
841000,360498,26811,26942,414251,24
841500,359744,26821,27010,413575,27
841500,358968,26566,28019,413553,24
841500,349936,27492,26588,404016,24
841500,349196,27875,26841,403912,23
841500,352990,26636,26921,406547,24
842000,349719,26249,26684,402652,26
842000,348732,33015,34366,416113,20
842000,348438,26191,26283,400912,23
842000,344914,26450,27992,399356,21
842000,346469,27179,26902,400550,20
842500,347948,26658,27331,401937,29
842500,360783,26123,26392,413298,29
842500,341832,26342,26428,394602,21
842500,351917,26394,26848,405159,25
842500,346251,27755,26665,400671,27
843000,348572,27340,26429,402341,21
843000,344693,26736,27081,398510,18
843000,350444,27154,28481,406079,24
843000,348143,26419,27204,401766,30
843000,353910,27375,27986,409271,24
843500,347783,27106,26661,401550,22
843500,351748,26745,26639,405132,21
843500,348622,26892,26743,402257,23
843500,348955,26510,27028,402493,20
843500,347161,26233,26389,399783,24
844000,346367,26217,26487,399071,28
844000,349694,26734,26903,403331,24
844000,349303,27007,27462,403772,27
844000,349871,27921,29126,406918,23
844000,353133,27678,30240,411051,18
844500,347477,26644,26655,400776,26
844500,344874,27623,26431,398928,27
844500,354872,27673,26683,409228,25
844500,350815,26541,26683,404039,27
844500,359869,26519,27093,413481,28
845000,342864,26439,27462,396765,22
845000,364899,29644,27546,422089,26
845000,349557,26791,27367,403715,20
845000,353382,27706,26953,408041,21
845000,348311,26499,27080,401890,24
845500,350564,27585,26995,405144,25
845500,348902,26905,27479,403286,30
845500,349647,26893,26916,403456,21
845500,348427,26924,27538,402889,24
845500,347243,26570,26715,400528,22
846000,351502,26842,26984,405328,21
846000,351979,27275,27486,406740,26
846000,347802,26502,26727,401031,25
846000,349119,26577,27046,402742,21
846000,350993,27093,27476,405562,23
846500,352100,27123,28941,408164,29
846500,346482,27327,27064,400873,24
846500,346397,26399,26433,399229,27
846500,349500,27856,26915,404271,24
846500,351073,27096,27520,405689,27
847000,352264,26620,26851,405735,18
847000,346169,26271,29162,401602,26
847000,348357,27318,27196,402871,24
847000,348882,26823,26744,402449,28
847000,348581,27380,28429,404390,24
847500,346124,26246,27248,399618,25
847500,357932,27220,27097,412249,25
847500,415282,26378,27174,468834,23
847500,353162,27149,26987,407298,19
847500,348186,26644,27094,401924,17
848000,346529,27184,26782,400495,22
848000,345542,29110,27311,401963,25
848000,345238,27687,26566,399491,24
848000,346312,26910,27168,400390,32
848000,352229,27017,27439,406685,23
848500,350899,27092,27227,405218,23
848500,354119,26788,27191,408098,20
848500,349104,27149,27060,403313,23
848500,344335,28814,28967,402116,22
848500,342229,26561,26529,395319,24
849000,353673,26931,27484,408088,24
849000,355176,26836,26886,408898,27
849000,348500,27847,27536,403883,25
849000,354067,26634,27203,407904,25
849000,350407,27321,27970,405698,26
849500,354442,27236,27206,408884,29
849500,350138,26714,27114,403966,27
849500,343223,28528,26659,398410,20
849500,344127,26475,26453,397055,21
849500,352858,27094,27144,407096,25
850000,351972,30500,48498,430970,30
850000,354271,27497,27161,408929,22
850000,353090,27275,27235,407600,25
850000,350685,27343,27150,405178,26
850000,364096,27425,26984,418505,27
850500,365876,26293,26490,418659,28
850500,348010,27049,26859,401918,29
850500,364813,27113,27016,418942,20
850500,351410,27234,26973,405617,24
850500,349767,29615,27054,406436,19
851000,355168,27173,27263,409604,22
851000,354837,26964,26901,408702,23
851000,348277,26989,26556,401822,22
851000,358929,26989,27168,413086,20
851000,360611,27186,27622,415419,24
851500,355369,27117,26874,409360,27
851500,354499,27093,26934,408526,26
851500,351654,26751,27216,405621,19
851500,344465,26351,27372,398188,23
851500,353099,27100,27217,407416,23
852000,351797,26982,27617,406396,21
852000,353984,27223,27536,408743,29
852000,353168,27754,27004,407926,23
852000,352365,27604,27186,407155,20
852000,357943,27340,27318,412601,23
852500,350605,26775,27375,404755,24
852500,348019,26921,26539,401479,23
852500,352436,27166,27455,407057,28
852500,355829,27092,27613,410534,25
852500,352946,26793,27826,407565,23
853000,351944,27131,27483,406558,27
853000,359119,27079,27791,413989,25
853000,349437,27394,27184,404015,23
853000,374793,26338,26552,427683,29
853000,346744,26383,27829,400956,25
853500,351917,28872,47133,427922,31
853500,349709,26420,29629,405758,26
853500,357086,28360,27612,413058,23
853500,349108,27038,27905,404051,17
853500,351431,26936,26918,405285,21
854000,353837,26518,26941,407296,23
854000,356711,26938,27882,411531,22
854000,354533,27772,27252,409557,22
854000,354574,27140,27625,409339,23
854000,357092,27179,27417,411688,21
854500,357538,27225,27072,411835,28
854500,365352,27029,27655,420036,16
854500,354691,26857,27463,409011,26
854500,350896,28005,27543,406444,23
854500,354830,27211,27264,409305,21
855000,354237,27343,27308,408888,20
855000,351115,26818,28258,406191,22
855000,352191,26840,26968,405999,27
855000,353732,26997,26909,407638,24
855000,364148,29229,27289,420666,35
855500,352265,26869,28098,407232,26
855500,364004,26816,27499,418319,27
855500,353084,27452,27318,407854,23
855500,350441,27544,27303,405288,25
855500,349829,26911,27052,403792,22
856000,372265,27400,27462,427127,23
856000,370221,27396,26994,424611,23
856000,349456,26378,26665,402499,19
856000,358976,28032,28949,415957,19
856000,350349,26919,27211,404479,22
856500,354792,27423,27510,409725,21
856500,363767,27310,27338,418415,21
856500,353756,29199,27120,410075,26
856500,352810,27716,27679,408205,24
856500,355087,30128,27362,412577,25
857000,353806,26849,27204,407859,24
857000,351844,27088,27013,405945,23
857000,348072,26567,26656,401295,24
857000,356069,27982,30132,414183,24
857000,352376,27331,27054,406761,24
857500,353938,27073,26782,407793,25
857500,352469,26864,26977,406310,22
857500,355945,29394,29581,414920,19
857500,354251,27902,27064,409217,25
857500,356113,26998,27186,410297,24
858000,352190,27310,27502,407002,22
858000,355130,26917,27075,409122,26
858000,355497,26901,26933,409331,22
858000,356200,26555,26813,409568,20
858000,352787,27137,27156,407080,21
858500,354262,28569,27609,410440,23
858500,349988,26514,28638,405140,28
858500,352424,27356,27726,407506,27
858500,351366,27294,27088,405748,18
858500,374487,33429,29435,437351,27
859000,352198,26677,27794,406669,25
859000,353889,26918,27577,408384,19
859000,352391,26606,26774,405771,18
859000,362188,26936,27193,416317,23
859000,377117,27855,27385,432357,27
859500,357818,27398,27370,412586,19
859500,356953,27432,27516,411901,23
859500,355371,27096,27333,409800,26
859500,347589,27104,27146,401839,25
859500,351085,26674,27046,404805,25
860000,353926,27548,26700,408174,20
860000,350686,26974,27124,404784,25
860000,353651,27778,28728,410157,23
860000,353682,26688,26772,407142,23
860000,360595,27297,29203,417095,28
860500,362448,27289,27223,416960,20
860500,353401,27056,28012,408469,26
860500,353098,27122,26735,406955,23
860500,362132,27422,27137,416691,20
860500,355840,28092,28270,412202,21
861000,355563,26957,27547,410067,25
861000,348055,26945,26957,401957,24
861000,355039,26719,26817,408575,25
861000,351995,26976,26838,405809,30
861000,358359,27357,27176,412892,26
861500,356146,27043,27212,410401,20
861500,356553,27533,27396,411482,18
861500,355685,27846,27454,410985,27
861500,352224,27576,27417,407217,22
861500,353804,27114,29135,410053,25
862000,358387,27088,27628,413103,25
862000,356776,27549,27198,411523,20
862000,355332,27755,29554,412641,26
862000,359993,27321,27427,414741,22
862000,358216,27803,27210,413229,25
862500,416111,27014,27665,470790,27
862500,351550,28234,27142,406926,21
862500,352118,27434,28246,407798,24
862500,356450,27235,27635,411320,15
862500,361079,27077,27488,415644,15
863000,357107,27299,27537,411943,27
863000,358969,27091,27250,413310,23
863000,350440,26576,26810,403826,24
863000,360912,27049,27205,415166,23
863000,359195,27023,27288,413506,29
863500,355804,28329,27416,411549,27
863500,356514,32889,29042,418445,29
863500,354921,27108,27360,409389,24
863500,347696,26658,27108,401462,27
863500,353379,26714,27322,407415,24
864000,376223,27367,27686,431276,17
864000,351974,27327,27793,407094,26
864000,353291,26628,26925,406844,21
864000,353909,27183,27281,408373,25
864000,350619,26884,26956,404459,24
864500,353187,30337,26888,410412,26
864500,355062,26777,26861,408700,30
864500,351784,26726,26990,405500,22
864500,349641,30376,27652,407669,22
864500,381307,26712,26899,434918,29
865000,353592,27116,27318,408026,23
865000,352918,27118,27345,407381,22
865000,352331,32971,27537,412839,20
865000,363368,26697,27209,417274,25
865000,349407,26699,26869,402975,27
865500,357544,27661,27470,412675,24
865500,346848,27853,28798,403499,29
865500,357649,26746,27143,411538,20
865500,351903,26940,26926,405769,26
865500,350577,26820,26921,404318,25
866000,349313,27354,27030,403697,22
866000,348616,27323,26995,402934,23
866000,360123,26944,26916,413983,21
866000,353017,26909,29656,409582,22
866000,348704,26746,26939,402389,25
866500,370865,26699,26929,424493,18
866500,346541,27208,27454,401203,23
866500,360939,27208,27346,415493,18
866500,356644,27186,27317,411147,25
866500,361329,27143,28069,416541,21
867000,348876,27276,27010,403162,24
867000,353409,26716,26972,407097,25
867000,350692,26745,28483,405920,24
867000,385475,26857,27039,439371,25
867000,354935,26994,27093,409022,26
867500,356500,26728,26990,410218,24
867500,351066,27376,27800,406242,25
867500,353559,26817,26984,407360,22
867500,348561,27434,27059,403054,32
867500,347539,26812,27009,401360,27
868000,366443,27150,27135,420728,23
868000,360053,26774,26994,413821,26
868000,352445,26845,27073,406363,25
868000,353685,26752,27024,407461,22
868000,351899,26770,27059,405728,13
868500,349996,27367,27139,404502,21
868500,355591,26892,27215,409698,26
868500,349876,26834,27240,403950,28
868500,354915,27017,27541,409473,24
868500,347097,26989,27027,401113,22
869000,364568,27068,27081,418717,21
869000,348603,26868,27328,402799,27
869000,351626,26883,27425,405934,20
869000,358217,26986,27591,412794,19
869000,350000,26872,27368,404240,22
869500,358251,27057,26956,412264,25
869500,359316,26868,27086,413270,22
869500,352527,26885,27147,406559,28
869500,346872,26887,27077,400836,35
869500,353351,29326,33626,416303,21
870000,417344,33591,34115,485050,24
870000,376921,26907,27103,430931,22
870000,363217,26911,27293,417421,22
870000,367817,26905,27103,421825,23
870000,353652,26837,27895,408384,22
870500,353576,26999,27090,407665,15
870500,359586,27528,27652,414766,26
870500,357302,27561,36855,421718,20
870500,350258,26850,27176,404284,19
870500,365586,26979,31364,423929,22
871000,358137,27308,27466,412911,28
871000,366879,27036,27173,421088,19
871000,349920,26896,27106,403922,23
871000,362233,27081,27110,416424,25
871000,351460,27310,27128,405898,23
871500,350661,27295,27122,405078,27
871500,349725,27178,27627,404530,25
871500,350066,29161,27928,407155,28
871500,349659,27216,27167,404042,22
871500,351393,28426,27661,407480,26
872000,353356,26938,27143,407437,24
872000,352038,26923,27120,406081,24
872000,354162,28065,27150,409377,25
872000,358891,27453,27606,413950,25
872000,353377,26867,27138,407382,20
872500,354939,26991,27207,409137,24
872500,364871,26926,27142,418939,21
872500,351824,26970,27161,405955,22
872500,352524,26972,27404,406900,28
872500,351615,27565,27214,406394,28
873000,351268,27025,27165,405458,27
873000,352936,26988,27217,407141,23
873000,349758,27070,27297,404125,23
873000,353675,27507,27661,408843,23
873000,387761,27121,27203,442085,20
873500,355824,27350,28022,411196,22
873500,355678,27085,27216,409979,29
873500,354198,27575,27491,409264,23
873500,352708,27164,28276,408148,23
873500,363030,26988,27268,417286,18
874000,353076,27520,27487,408083,24
874000,351865,27665,27403,406933,22
874000,354216,27117,27255,408588,28
874000,355546,27052,27282,409880,24
874000,361110,27284,27207,415601,21
874500,369149,27085,27549,423783,21
874500,351865,27091,27303,406259,20
874500,357695,28087,27918,413700,23
874500,353402,26958,27373,407733,24
874500,365334,27285,27161,419780,21
875000,364242,27756,27792,419790,23
875000,355827,27093,27251,410171,19
875000,353815,27248,27209,408272,29
875000,360473,27593,28386,416452,26
875000,353040,27007,27166,407213,22
875500,372598,27654,27617,427869,22
875500,382699,37140,27218,447057,25
875500,355052,27111,27324,409487,21
875500,353474,27145,27195,407814,27
875500,353740,27015,27283,408038,25
876000,364571,35766,39839,440176,29
876000,351692,27032,27254,405978,28
876000,364913,27073,27282,419268,21
876000,359016,27548,28009,414573,26
876000,358150,27463,27850,413463,20
876500,351359,27023,27250,405632,24
876500,356202,27026,27261,410489,23
876500,357308,27449,27958,412715,27
876500,357697,27476,27458,412631,18
876500,358101,27015,27244,412360,29
877000,355975,27667,27818,411460,26
877000,353247,27052,27279,407578,23
877000,352865,27087,27566,407518,25
877000,352557,27097,27298,406952,24
877000,357567,26902,27163,411632,25
877500,354546,27113,28786,410445,21
877500,363144,27096,27291,417531,25
877500,356689,28486,28364,413539,22
877500,352360,27144,27302,406806,19
877500,353401,27438,29730,410569,23
878000,354814,27118,27284,409216,25
878000,357307,27168,28029,412504,26
878000,353997,27113,27326,408436,23
878000,357566,28365,28376,414307,27
878000,355170,27163,27363,409696,20
878500,352657,27736,27845,408238,22
878500,351693,27190,27366,406249,28
878500,356892,27072,27283,411247,25
878500,357382,34705,34325,426412,35
878500,357253,27089,27374,411716,21
879000,355337,27407,29461,412205,23
879000,353973,27134,27371,408478,23
879000,392415,28218,27243,447876,25
879000,353739,27168,27988,408895,19
879000,358769,27539,27297,413605,31
879500,358484,29756,29737,417977,26
879500,368770,27516,27730,424016,25
879500,357416,27149,27679,412244,27
879500,363590,27160,28493,419243,21
879500,356857,27069,27345,411271,16
880000,356091,27203,27450,410744,24
880000,360993,27484,27295,415772,20
880000,362194,27580,27936,417710,25
880000,369263,27575,27782,424620,20
880000,363186,27345,27803,418334,24
880500,365505,27295,40439,433239,29
880500,358796,27177,27434,413407,25
880500,354912,27273,27800,409985,23
880500,356898,28481,27931,413310,28
880500,352605,27496,27450,407551,31
881000,356634,27384,27580,411598,23
881000,407794,34139,34320,476253,22
881000,355722,27277,27436,410435,21
881000,354495,27324,27499,409318,21
881000,355214,27198,27343,409755,25
881500,357032,27282,27548,411862,18
881500,354640,27259,27468,409367,21
881500,363123,27616,27798,418537,23
881500,353198,27172,27445,407815,25
881500,356940,27384,27702,412026,25
882000,362198,27637,27880,417715,22
882000,353241,27502,27379,408122,25
882000,358192,27575,27539,413306,24
882000,354571,27193,27421,409185,19
882000,357437,27369,27559,412365,25
882500,356052,27244,27505,410801,25
882500,357507,27250,27506,412263,27
882500,354721,27260,27491,409472,24
882500,353976,27243,27481,408700,28
882500,354542,27502,27520,409564,23
883000,353863,27969,28479,410311,21
883000,354694,28316,28388,411398,18
883000,363115,27800,27875,418790,29
883000,355070,27341,27499,409910,26
883000,355727,27285,28708,411720,26
883500,356625,27810,28156,412591,24
883500,353377,27422,27519,408318,24
883500,360015,27602,27474,415091,23
883500,356266,27269,27459,410994,20
883500,358863,27687,30426,416976,23
884000,355561,27311,27498,410370,22
884000,368577,27357,27577,423511,21
884000,360355,27346,27560,415261,23
884000,361883,27300,29183,418366,30
884000,360132,27558,27906,415596,27
884500,357691,27386,27774,412851,22
884500,370955,27844,28096,426895,27
884500,360635,27319,27548,415502,23
884500,360993,28947,28280,418220,27
884500,362552,27747,27875,418174,24
885000,369409,28035,28194,425638,21
885000,356592,27371,27583,411546,25
885000,357454,27417,27932,412803,25
885000,361605,27337,27538,416480,30
885000,366528,28151,28114,422793,28
885500,366775,27745,27894,422414,26
885500,356074,27277,27546,410897,27
885500,358508,27736,27790,414034,26
885500,359425,27389,27838,414652,22
885500,366554,27568,28007,422129,25
886000,362148,27416,27641,417205,23
886000,362473,27423,27627,417523,28
886000,367797,27748,28007,423552,24
886000,357234,27453,27618,412305,22
886000,355700,27375,27644,410719,22
886500,361494,27960,28210,417664,21
886500,415319,34178,34416,483913,23
886500,354692,27405,27588,409685,23
886500,355460,27375,27701,410536,23
886500,357212,27653,27658,412523,21
887000,359915,27659,27766,415340,27
887000,378975,27523,27600,434098,20
887000,371509,28344,28362,428215,23
887000,361101,27538,27598,416237,18
887000,365629,27402,27628,420659,20
887500,368186,27439,27696,423321,26
887500,361496,27455,27653,416604,20
887500,358802,27528,27648,413978,26
887500,356953,27469,27755,412177,18
887500,368575,27557,27811,423943,26
888000,372616,27482,27633,427731,25
888000,359910,27895,27662,415467,24
888000,367723,27533,27865,423121,23
888000,358957,27855,27918,414730,25
888000,366128,27455,27751,421334,26
888500,361271,27520,27671,416462,20
888500,356997,27493,27717,412207,25
888500,357203,27466,27742,412411,20
888500,359873,27460,27818,415151,20
888500,358431,28405,27668,414504,25
889000,365644,27579,28192,421415,21
889000,357711,27510,27722,412943,29
889000,363691,27845,28017,419553,20
889000,357926,29050,28314,415290,26
889000,358410,27527,27714,413651,18
889500,361068,28054,28570,417692,23
889500,364947,27594,28445,420986,26
889500,361870,27723,27920,417513,27
889500,368876,28589,28921,426386,25
889500,367331,27502,27886,422719,23
890000,369667,27433,27696,424796,20
890000,361843,27532,27739,417114,25
890000,356336,27574,27758,411668,27
890000,359622,29656,28350,417628,18
890000,368402,32818,27946,429166,25
890500,363030,27538,27801,418369,25
890500,358648,27862,28464,414974,26
890500,360819,27574,32233,420626,29
890500,376642,28030,28331,433003,25
890500,358551,28008,27875,414434,20
891000,364053,27518,28027,419598,24
891000,363906,27563,28055,419524,25
891000,377400,27514,27773,432687,22
891000,365255,27924,29320,422499,24
891000,362853,27567,27774,418194,26
891500,370318,27929,28266,426513,23
891500,362345,27636,27972,417953,18
891500,361225,27573,27890,416688,17
891500,358758,27783,27871,414412,26
891500,359706,27572,27779,415057,25
892000,358705,27642,28346,414693,23
892000,415707,42602,35216,493525,24
892000,359321,27547,27824,414692,24
892000,364129,27635,27845,419609,22
892000,376097,27717,27632,431446,25
892500,365859,28195,28380,422434,28
892500,361224,27945,27746,416915,25
892500,366439,27545,27709,421693,20
892500,366863,27988,32562,427413,24
892500,363022,30900,27635,421557,30
893000,360422,27659,27843,415924,19
893000,361079,27635,34316,423030,26
893000,366098,28278,28370,422746,21
893000,364597,27712,27822,420131,23
893000,363251,27704,27841,418796,29
893500,360456,27600,27819,415875,23
893500,369946,27851,27896,425693,23
893500,362430,28157,27996,418583,22
893500,362658,27591,27804,418053,23
893500,366859,27597,27800,422256,23
894000,363450,27611,27891,418952,20
894000,369739,27643,27845,425227,20
894000,367096,27677,27859,422632,22
894000,370396,28938,28358,427692,28
894000,367650,28254,28784,424688,18
894500,369695,28217,28305,426217,19
894500,371411,28652,28246,428309,25
894500,372521,28097,28166,428784,25
894500,378440,30103,29063,437606,22
894500,365076,34642,27839,427557,24
895000,368805,28222,28494,425521,25
895000,371010,28075,28263,427348,18
895000,362411,28138,27817,418366,25
895000,361618,27999,28004,417621,27
895000,367367,27676,27867,422910,22
895500,397800,27725,27929,453454,33
895500,360162,28027,27873,416062,22
895500,365869,27711,29771,423351,24
895500,379767,35138,32180,447085,25
895500,368673,27701,27977,424351,20
896000,363707,27780,27938,419425,23
896000,364254,27711,27970,419935,22
896000,362469,27681,27876,418026,25
896000,362539,27693,27909,418141,32
896000,363716,29153,30674,423543,23
896500,364792,28071,27924,420787,21
896500,361017,27772,27937,416726,20
896500,361500,27720,27997,417217,22
896500,363923,29252,29375,422550,22
896500,368521,27730,27888,424139,20
897000,360622,27811,28011,416444,25
897000,395420,27869,27946,451235,21
897000,361420,28716,29581,419717,25
897000,367924,29944,28822,426690,28
897000,363068,27689,27911,418668,23
897500,369840,44942,44993,459775,25
897500,363905,29123,30560,423588,22
897500,362950,27731,27962,418643,24
897500,366150,27967,29013,423130,25
897500,365689,27863,28032,421584,21
898000,363323,27891,28204,419418,22
898000,366781,27957,28486,423224,27
898000,368197,27730,28333,424260,24
898000,361666,27758,27976,417400,21
898000,363364,28013,28008,419385,23
898500,364598,27827,27982,420407,23
898500,361789,27821,28001,417611,15
898500,362848,28087,27970,418905,29
898500,368078,27841,28050,423969,21
898500,363463,27888,28052,419403,29
899000,398498,28032,29582,456112,24
899000,363341,30076,28447,421864,25
899000,373246,27868,28027,429141,23
899000,375338,27879,28065,431282,28
899000,363936,27793,28032,419761,27
899500,369392,27876,27996,425264,27
899500,366845,28280,28020,423145,25
899500,374682,27845,28030,430557,20
899500,365141,27893,28001,421035,20
899500,368620,28099,27989,424708,26
900000,366683,27864,28041,422588,21
900000,363449,27800,28070,419319,27
900000,423541,36093,35107,494741,25
900000,361757,27819,28083,417659,25
900000,361529,29155,27988,418672,24
900500,373407,28358,28370,430135,22
900500,370546,27964,28080,426590,18
900500,370693,28172,28165,427030,26
900500,371492,27840,28808,428140,25
900500,362727,27999,28120,418846,30
901000,380422,34896,29335,444653,25
901000,366581,27752,28085,422418,24
901000,370710,28568,28404,427682,24
901000,369917,28192,28404,426513,24
901000,371576,28213,28418,428207,22
901500,373464,28229,28512,430205,19
901500,371389,31791,31542,434722,23
901500,368936,28775,28411,426122,19
901500,370173,29306,28801,428280,23
901500,371775,28414,28945,429134,24
902000,366795,27946,28035,422776,19
902000,378337,28025,28157,434519,27
902000,370553,28164,28292,427009,22
902000,388072,27856,28085,444013,25
902000,363530,27883,28245,419658,25
902500,361516,27868,28093,417477,27
902500,365650,27863,28079,421592,29
902500,368031,27852,28095,423978,22
902500,372218,32926,28737,433881,25
902500,364642,27925,28168,420735,22
903000,369669,28057,30549,428275,19
903000,364370,27893,28125,420388,26
903000,373707,27901,28237,429845,22
903000,364954,27905,28136,420995,21
903000,364865,27920,28087,420872,28
903500,368085,27909,28086,424080,26
903500,373131,28302,29258,430691,24
903500,369385,28300,28460,426145,27
903500,364113,27872,28088,420073,24
903500,377083,28236,28952,434271,19
904000,370929,27895,28130,426954,28
904000,370305,28858,29458,428621,26
904000,365207,27923,28108,421238,28
904000,366148,27905,29124,423177,25
904000,362490,28071,28126,418687,23
904500,364155,27940,28133,420228,19
904500,380994,27976,28226,437196,26
904500,363903,28009,28154,420066,22
904500,363186,27951,28137,419274,22
904500,366235,28429,30001,424665,22
905000,390245,28581,28852,447678,19
905000,384267,28447,28928,441642,21
905000,369841,28881,28348,427070,25
905000,370121,27881,28075,426077,22
905000,373470,28711,28938,431119,19
905500,372264,28346,28576,429186,23
905500,376998,28791,29076,434865,21
905500,364614,28049,28178,420841,20
905500,375723,27924,28140,431787,23
905500,366040,28134,28276,422450,27
906000,386987,28617,28767,444371,24
906000,396245,30113,29915,456273,17
906000,375756,28774,29242,433772,21
906000,375596,28676,29321,433593,26
906000,384901,30771,29203,444875,18
906500,380248,29067,30581,439896,20
906500,375874,29139,29932,434945,21
906500,392342,28440,28586,449368,28
906500,381431,29187,28609,439227,28
906500,376965,27922,28338,433225,24
907000,379297,28251,29403,436951,21
907000,373132,28930,29761,431823,28
907000,378823,28409,28639,435871,24
907000,379004,28642,29933,437579,25
907000,377223,29537,28946,435706,20
907500,376776,31606,29811,438193,27
907500,382512,30013,29810,442335,23
907500,378778,28909,29203,436890,23
907500,373598,28440,29627,431665,26
907500,368388,28298,28602,425288,22
908000,380730,29084,29617,439431,26
908000,382224,28474,29000,439698,23
908000,378145,28618,29089,435852,25
908000,398994,31218,29084,459296,28
908000,378997,28753,28722,436472,24
908500,376980,28402,29043,434425,23
908500,379996,28952,29003,437951,24
908500,376856,28727,29079,434662,24
908500,387310,29238,29633,446181,27
908500,375311,28556,29010,432877,22
909000,378131,30190,29959,438280,26
909000,380023,28994,28855,437872,28
909000,379893,28662,28656,437211,23
909000,379576,30262,28992,438830,20
909000,379184,28770,29343,437297,20
909500,382187,28848,29140,440175,25
909500,379681,29643,28906,438230,26
909500,374695,28468,28195,431358,20
909500,376701,29085,29456,435242,25
909500,384167,29066,28766,441999,30
910000,379134,28889,28905,436928,20
910000,384233,28515,28661,441409,23
910000,377959,28742,29227,435928,22
910000,379380,28478,28739,436597,20
910000,373872,29338,29115,432325,27
910500,381008,29722,28745,439475,22
910500,383319,28658,28926,440903,23
910500,381551,29251,28692,439494,25
910500,379777,29822,29319,438918,18
910500,378407,30857,29876,439140,30
911000,394052,29855,29216,453123,20
911000,376771,28373,28349,433493,33
911000,378634,29376,30163,438173,20
911000,382440,28518,29047,440005,25
911000,374312,28685,28691,431688,28
911500,386393,28417,29035,443845,20
911500,373977,28519,28407,430903,28
911500,379113,28197,31145,438455,20
911500,372763,30487,29501,432751,27
911500,383227,29752,29396,442375,21
912000,380790,28537,28810,438137,15
912000,380142,28581,29182,437905,26
912000,382615,29106,28723,440444,27
912000,376082,28602,28898,433582,22
912000,376633,28910,29131,434674,21
912500,379460,28596,29251,437307,27
912500,371245,28259,28958,428462,20
912500,380131,28389,28462,436982,21
912500,374596,28448,28602,431646,17
912500,375190,28339,28887,432416,22
913000,380477,28851,28968,438296,21
913000,376689,28618,28894,434201,21
913000,382094,28619,28783,439496,28
913000,378989,28902,28870,436761,26
913000,387308,30341,29149,446798,29
913500,378294,28613,29531,436438,22
913500,378914,28224,31199,438337,23
913500,371349,28289,28482,428120,20
913500,379476,28989,28839,437304,26
913500,379340,28846,28955,437141,24
914000,387483,29119,29532,446134,31
914000,378003,28809,29070,435882,25
914000,382742,28869,29128,440739,21
914000,380861,28655,29698,439214,19
914000,379066,28738,29570,437374,23
914500,374215,29656,29234,433105,21
914500,382926,28621,29559,441106,23
914500,384067,29045,29164,442276,24
914500,393357,28960,29904,452221,26
914500,383750,29494,29275,442519,22
915000,383427,29602,29749,442778,24
915000,385280,29023,28913,443216,27
915000,383079,29062,30699,442840,26
915000,380022,28951,28819,437792,19
915000,381520,29045,29646,440211,29
915500,379833,28695,29218,437746,26
915500,383586,28644,28876,441106,23
915500,380340,29081,30493,439914,24
915500,381752,28799,30027,440578,24
915500,382577,29012,29605,441194,23
916000,381621,38814,29511,449946,24
916000,378991,28937,29369,437297,24
916000,394660,35171,38848,468679,21
916000,379961,28214,28423,436598,14
916000,380369,29025,29484,438878,21
916500,379441,29717,33516,442674,27
916500,393542,29221,29507,452270,27
916500,379059,29247,28913,437219,31
916500,382133,29490,28974,440597,25
916500,379366,28969,29303,437638,25
917000,383424,28834,29196,441454,25
917000,383125,29658,29348,442131,24
917000,384577,28892,29301,442770,27
917000,381411,28876,29616,439903,19
917000,384079,28784,29426,442289,23
917500,385302,72412,29890,487604,29
917500,382652,29046,29573,441271,25
917500,387071,29336,30926,447333,24
917500,397958,29341,28802,456101,21
917500,393395,28882,29226,451503,29
918000,393629,29548,29380,452557,26
918000,382454,29867,29129,441450,19
918000,384803,28968,29589,443360,25
918000,384476,29737,29230,443443,23
918000,380848,28933,29027,438808,20
918500,386171,29317,31396,446884,25
918500,395659,29224,30107,454990,19
918500,391431,28822,29481,449734,24
918500,389612,29363,28954,447929,19
918500,381703,29135,29023,439861,25
919000,384307,29978,30194,444479,23
919000,381384,29963,29123,440470,21
919000,380736,29582,29438,439756,29
919000,383783,29110,29285,442178,23
919000,386677,28468,29407,444552,30
919500,394650,31522,30041,456213,23
919500,388748,29038,28915,446701,25
919500,379549,30401,30368,440318,26
919500,396793,29925,29172,455890,22
919500,388883,30369,29622,448874,24
920000,382396,29537,30206,442139,25
920000,387104,28936,29073,445113,24
920000,386540,28958,29988,445486,24
920000,378457,28879,29487,436823,25
920000,381559,28875,29050,439484,22
920500,387261,28854,29739,445854,23
920500,382961,29267,29792,442020,23
920500,382599,29588,29097,441284,18
920500,381870,28901,28933,439704,23
920500,382814,29411,29139,441364,25
921000,388860,33826,34172,456858,28
921000,384485,29539,29782,443806,28
921000,380779,28826,29333,438938,27
921000,383553,29016,29316,441885,26
921000,382614,28563,29351,440528,31
921500,386732,29439,30179,446350,22
921500,384192,29095,29318,442605,19
921500,385106,28959,29366,443431,24
921500,383198,29146,29294,441638,17
921500,383361,29595,29455,442411,28
922000,385849,29322,29091,444262,24
922000,389606,29028,29088,447722,22
922000,384332,29302,29741,443375,27
922000,382767,29565,29187,441519,26
922000,379859,28788,29619,438266,24
922500,390380,29459,30087,449926,24
922500,384449,29053,29179,442681,25
922500,389797,29440,29760,448997,21
922500,383389,29319,29705,442413,25
922500,388625,29137,29106,446868,25
923000,384099,29970,39999,454068,23
923000,387443,29250,29634,446327,21
923000,391288,29009,31897,452194,20
923000,394301,28623,30473,453397,24
923000,395388,30016,30009,455413,20
923500,384860,29092,30215,444167,26
923500,383327,29685,29263,442275,24
923500,385469,29671,29503,444643,27
923500,386096,28568,28981,443645,21
923500,391418,33692,33333,458443,20
924000,418309,42986,36060,497355,26
924000,391164,30873,28966,451003,23
924000,391274,30330,30039,451643,21
924000,387067,30000,30377,447444,19
924000,386315,29123,29691,445129,27
924500,393307,30518,30080,453905,25
924500,388384,29500,29445,447329,32
924500,388309,30245,29197,447751,25
924500,388074,29350,29146,446570,22
924500,387432,28970,29724,446126,24
925000,395635,30972,30286,456893,29
925000,412599,30425,30430,473454,16
925000,388628,30570,29528,448726,21
925000,383743,28655,28995,441393,22
925000,389442,29735,30031,449208,23
925500,386836,28999,29642,445477,23
925500,394367,29317,29785,453469,28
925500,393486,29620,29753,452859,25
925500,394333,29093,29422,452848,29
925500,397493,30898,29866,458257,27
926000,387819,29652,29333,446804,28
926000,394634,29651,29794,454079,25
926000,388300,29176,30119,447595,22
926000,386348,29636,29728,445712,24
926000,386139,29926,29400,445465,24
926500,418071,43505,37152,498728,28
926500,386524,29134,29655,445313,23
926500,381653,30452,30976,443081,19
926500,390033,29084,29319,448436,17
926500,387266,29712,29504,446482,21
927000,390264,30691,30428,451383,17
927000,385791,29166,29600,444557,25
927000,386653,29661,29963,446277,29
927000,390750,30396,29904,451050,24
927000,388138,29474,30559,448171,22
927500,391133,29673,29286,450092,22
927500,393837,29086,30108,453031,23
927500,394170,29477,29709,453356,15
927500,395008,29461,29546,454015,24
927500,389096,29159,28892,447147,22
928000,385298,31027,29945,446270,24
928000,383436,28848,29052,441336,22
928000,402122,37116,29447,468685,24
928000,384686,28958,28942,442586,26
928000,388867,29079,30354,448300,25
928500,394653,29545,29516,453714,25
928500,387816,29265,29670,446751,19
928500,388422,30296,30347,449065,21
928500,386424,29502,29375,445301,26
928500,390071,29307,30206,449584,31
929000,384488,29504,29317,443309,22
929000,427320,29019,28938,485277,25
929000,381085,28888,29686,439659,20
929000,387219,29132,29354,445705,31
929000,391412,31765,29804,452981,24
929500,388802,29325,29601,447728,24
929500,403079,29547,29394,462020,18
929500,388239,29721,29331,447291,28
929500,378245,28755,29074,436074,22
929500,392589,30488,29918,452995,23
930000,383703,28677,29621,442001,20
930000,380022,29060,29738,438820,21
930000,383493,29350,29344,442187,19
930000,387658,29665,30052,447375,27
930000,389452,29163,29386,448001,22
930500,394804,29501,32104,456409,26
930500,388978,29420,29332,447730,25
930500,385149,28955,28872,442976,22
930500,388496,29908,29320,447724,20
930500,391020,30315,29601,450936,24
931000,393619,30335,29999,453953,23
931000,395020,29270,29468,453758,21
931000,392993,29235,30207,452435,18
931000,388962,29871,29706,448539,24
931000,410052,29216,29360,468628,22
931500,386826,29489,29171,445486,25
931500,395779,29096,29043,453918,16
931500,410041,29859,29159,469059,29
931500,415635,28674,29123,473432,22
931500,389189,29218,29439,447846,28
932000,389967,29019,34775,453761,23
932000,402217,28869,33029,464115,28
932000,396200,29857,29636,455693,26
932000,396096,29701,29402,455199,21
932000,395443,29592,29635,454670,19
932500,387090,50511,33646,471247,27
932500,381160,30955,29523,441638,23
932500,398698,30347,30091,459136,25
932500,399153,28794,30162,458109,23
932500,384594,30781,30311,445686,24
933000,391362,30058,29503,450923,21
933000,382559,29468,33266,445293,26
933000,387480,29293,29028,445801,23
933000,387338,29075,29549,445962,21
933000,387035,29286,29015,445336,20
933500,391031,30182,30615,451828,24
933500,388988,29633,29998,448619,26
933500,392904,29286,29809,451999,19
933500,394033,29616,30464,454113,26
933500,390798,30588,29513,450899,21
934000,389581,29603,29889,449073,17
934000,388599,30169,29485,448253,23
934000,388572,28961,29478,447011,22
934000,418991,29052,29261,477304,21
934000,392651,30116,31048,453815,26
934500,391895,30307,29480,451682,24
934500,390253,30069,29992,450314,26
934500,393258,30447,29501,453206,24
934500,391346,29412,29672,450430,19
934500,386017,29633,29503,445153,24
935000,381281,29059,29209,439549,24
935000,391958,29814,30525,452297,18
935000,387972,30045,29860,447877,25
935000,394546,28954,29091,452591,25
935000,405959,29290,30296,465545,16
935500,391199,29752,40628,461579,27
935500,394891,29874,30235,455000,26
935500,392196,29784,30178,452158,24
935500,388784,30322,33461,452567,25
935500,393248,29641,29578,452467,24
936000,393424,29619,29494,452537,21
936000,397262,29737,30134,457133,23
936000,384135,29690,29754,443579,24
936000,402259,29806,29656,461721,26
936000,385254,29632,30727,445613,25
936500,393972,31406,37082,462460,24
936500,400948,30355,29678,460981,25
936500,386530,28978,29294,444802,29
936500,401674,29514,29959,461147,21
936500,443196,31040,38617,512853,29
937000,394842,29412,35709,459963,25
937000,394888,30712,30719,456319,25
937000,396617,30330,29950,456897,28
937000,386238,28989,29844,445071,22
937000,384470,29042,29437,442949,22
937500,388144,30266,32730,451140,25
937500,395708,30010,29279,454997,22
937500,394896,30549,31194,456639,26
937500,393680,29600,29848,453128,23
937500,391970,30372,31963,454305,24
938000,397217,30174,39552,466943,23
938000,397077,29467,29878,456422,25
938000,392797,34394,30574,457765,22
938000,387966,29421,29304,446691,24
938000,407530,30283,29622,467435,20
938500,400598,30120,29618,460336,27
938500,392111,29622,29714,451447,20
938500,401089,29864,29727,460680,26
938500,392225,29849,29611,451685,25
938500,406010,29774,31460,467244,30
939000,390028,39700,29459,459187,28
939000,391622,29867,30558,452047,27
939000,391542,29410,29246,450198,22
939000,391419,30058,30164,451641,19
939000,427264,36832,37119,501215,29
939500,399973,29493,29615,459081,22
939500,390229,30371,30879,451479,26
939500,392620,30010,30207,452837,26
939500,391515,29686,29569,450770,21
939500,390839,29254,29702,449795,28
940000,393546,30394,30126,454066,24
940000,401808,29369,29265,460442,22
940000,390221,32172,30748,453141,26
940000,399175,31522,29670,460367,24
940000,392403,29622,29894,451919,21
940500,397633,29533,30169,457335,22
940500,396327,30063,29918,456308,25
940500,393953,29476,29857,453286,20
940500,397657,29842,30361,457860,25
940500,393677,29410,30037,453124,21
941000,391002,29520,29947,450469,22
941000,396903,29527,30005,456435,15
941000,393711,29637,29934,453282,20
941000,390187,29223,30490,449900,23
941000,403045,29649,29673,462367,25
941500,394750,29560,29672,453982,20
941500,394414,30580,29408,454402,19
941500,394243,29223,29287,452753,25
941500,388621,30284,29251,448156,28
941500,395317,29279,29578,454174,27
942000,453466,29228,41059,523753,24
942000,398174,31460,30297,459931,27
942000,401234,29834,31274,462342,25
942000,395778,29734,30983,456495,28
942000,390498,29039,30168,449705,23
942500,390540,29563,29441,449544,23
942500,395257,30178,30237,455672,26
942500,397868,29922,30947,458737,21
942500,393623,29974,30824,454421,23
942500,395651,30936,30377,456964,23
943000,396841,29640,29893,456374,21
943000,395630,30128,30616,456374,21
943000,391888,29984,29294,451166,23
943000,394251,30071,30042,454364,21
943000,399217,30626,30787,460630,23
943500,392840,30284,48595,471719,26
943500,399220,29686,29913,458819,26
943500,397565,30193,30279,458037,27
943500,396596,34519,30664,461779,19
943500,400465,30119,30794,461378,17
944000,393939,29827,30715,454481,18
944000,406441,30449,29827,466717,22
944000,393781,29558,30171,453510,24
944000,397741,29722,29917,457380,21
944000,388093,29589,31040,448722,19
944500,399952,33592,30957,464501,26
944500,401803,32047,31876,465726,22
944500,397107,29767,30483,457357,28
944500,410854,30481,30403,471738,25
944500,400401,29822,30092,460315,22
945000,399523,30986,29969,460478,27
945000,392699,29380,29654,451733,26
945000,396572,29262,29382,455216,24
945000,394936,29521,30868,455325,22
945000,400725,29964,30477,461166,28
945500,397093,29758,29946,456797,22
945500,393541,29797,29720,453058,20
945500,391912,29149,29971,451032,27
945500,393247,29169,35129,457545,26
945500,389588,29779,29402,448769,29
946000,398280,30175,30548,459003,24
946000,399312,29659,30041,459012,25
946000,399335,31528,30423,461286,17
946000,396927,29753,30701,457381,24
946000,388487,29598,30076,448161,30
946500,386319,31049,31929,449297,24
946500,395899,29064,29999,454962,27
946500,399257,30527,29478,459262,26
946500,395762,29684,29553,454999,29
946500,387338,31610,29662,448610,20
947000,506274,34133,37288,577695,29
947000,399769,30210,30183,460162,28
947000,399174,29940,30685,459799,24
947000,395163,30966,29808,455937,23
947000,396711,29685,32949,459345,26
947500,391926,31999,31960,455885,24
947500,397201,29334,30009,456544,25
947500,398845,29781,30453,459079,26
947500,414482,30660,30659,475801,22
947500,407036,31369,30048,468453,28
948000,398819,29916,32673,461408,25
948000,392566,29422,29580,451568,26
948000,412775,30602,30155,473532,21
948000,399859,29890,30836,460585,26
948000,388854,29943,29496,448293,25
948500,402497,30790,31369,464656,22
948500,396003,31248,30296,457547,27
948500,392958,30023,30713,453694,24
948500,404529,30475,30391,465395,27
948500,391060,29506,29712,450278,24
949000,393316,29703,29974,452993,23
949000,399403,29689,29858,458950,23
949000,395304,29624,29511,454439,28
949000,394931,29224,30314,454469,25
949000,393664,29548,30512,453724,20
949500,424216,30470,30678,485364,21
949500,398747,30318,31274,460339,27
949500,400472,29926,29932,460330,22
949500,393622,29689,29927,453238,31
949500,388078,29270,29831,447179,20
950000,396427,29722,32447,458596,24
950000,396008,30484,30440,456932,24
950000,409744,30974,29504,470222,26
950000,394966,32243,30299,457508,24
950000,392236,32589,30534,455359,21
950500,394458,31386,30989,456833,23
950500,392543,29413,35361,457317,22
950500,400015,29703,29899,459617,28
950500,394337,29924,29502,453763,18
950500,404301,30179,29515,463995,24
951000,405423,30469,30381,466273,21
951000,401341,29803,30027,461171,23
951000,398040,29879,30253,458172,26
951000,398878,30224,30247,459349,23
951000,410522,30145,29997,470664,28
951500,395867,30404,30028,456299,26
951500,395610,29757,29948,455315,25
951500,397757,30110,30343,458210,25
951500,399633,31163,30121,460917,28
951500,405260,29966,30547,465773,20
952000,411693,30189,40938,482820,28
952000,416905,29412,29609,475926,18
952000,398462,29477,31533,459472,18
952000,398818,29785,30584,459187,30
952000,400335,29746,30114,460195,20
952500,427082,35442,33919,496443,27
952500,399005,30184,30725,459914,26
952500,401368,33749,30368,465485,27
952500,397138,30219,29976,457333,23
952500,404415,29774,30000,464189,27
953000,398273,30633,30561,459467,22
953000,400871,30091,30078,461040,20
953000,399485,30933,29680,460098,23
953000,393045,29447,30067,452559,25
953000,400412,29914,30255,460581,23
953500,402418,31506,31512,465436,22
953500,402579,30232,30250,463061,23
953500,396331,30714,31044,458089,22
953500,403310,29834,30460,463604,23
953500,407457,31724,31481,470662,21
954000,403952,30107,30520,464579,19
954000,412196,30524,30901,473621,20
954000,397727,30485,30793,459005,21
954000,397890,30201,29773,457864,22
954000,406007,29891,30438,466336,22
954500,443175,32222,32651,508048,20
954500,397145,32467,30472,460084,31
954500,401145,29597,29897,460639,20
954500,400204,30760,30032,460996,25
954500,392498,30925,30423,453846,27
955000,399386,30134,30111,459631,18
955000,398284,30007,30533,458824,26
955000,392805,30084,31144,454033,28
955000,401932,31223,30177,463332,18
955000,402578,30029,30076,462683,27
955500,404983,29843,30367,465193,25
955500,402707,29884,31049,463640,21
955500,402490,30195,31017,463702,24
955500,399745,30265,31562,461572,23
955500,399166,30409,30209,459784,28
956000,399680,29991,30771,460442,18
956000,396435,30310,31479,458224,23
956000,405594,29893,29812,465299,26
956000,400360,30547,30337,461244,26
956000,400162,29880,30153,460195,22
956500,402464,30706,30464,463634,21
956500,401519,30291,32126,463936,25
956500,399016,35020,36517,470553,23
956500,401765,30001,30542,462308,22
956500,404784,30659,30998,466441,28
957000,406015,30152,30623,466790,17
957000,393549,29682,29932,453163,22
957000,397859,32869,29968,460696,25
957000,395409,29657,31458,456524,26
957000,409205,30257,30494,469956,26
957500,404686,30724,31037,466447,23
957500,398472,30129,30201,458802,27
957500,401929,30318,30191,462438,25
957500,399784,30444,31116,461344,22
957500,400518,30831,30474,461823,25
958000,409601,31966,30836,472403,30
958000,400953,30456,31154,462563,26
958000,402238,31463,30606,464307,25
958000,401200,30230,30447,461877,28
958000,402741,31196,30811,464748,26
958500,401960,30312,30693,462965,21
958500,396548,30763,31141,458452,22
958500,397346,30478,30385,458209,23
958500,402379,30394,30433,463206,22
958500,396761,29614,30751,457126,33
959000,392363,29737,41714,463814,26
959000,399216,30048,30523,459787,19
959000,403528,31190,29924,464642,30
959000,403766,30015,30249,464030,26
959000,446645,38019,37682,522346,23
959500,399131,30158,29900,459189,20
959500,403700,30865,30627,465192,23
959500,392701,29973,31288,453962,26
959500,397786,30096,29990,457872,21
959500,405778,29905,29943,465626,22
960000,401303,30549,34284,466136,25
960000,401407,30789,30590,462786,22
960000,403019,30200,31365,464584,19
960000,401296,30144,30471,461911,25
960000,404702,30857,31217,466776,20
960500,401648,30315,31245,463208,23
960500,408210,30650,30259,469119,18
960500,401201,30482,30420,462103,29
960500,396468,30177,31051,457696,25
960500,404830,30814,30645,466289,29
961000,403375,30780,31036,465191,19
961000,401057,30725,31537,463319,17
961000,403676,30855,30634,465165,18
961000,400982,30634,31165,462781,23
961000,398990,30267,30636,459893,21
961500,401598,30385,30485,462468,22
961500,398661,30112,30321,459094,18
961500,410050,30173,30408,470631,22
961500,405261,30777,30961,466999,28
961500,410961,30077,30761,471799,23
962000,409357,33114,35741,478212,24
962000,397918,29761,30462,458141,24
962000,396352,30700,30341,457393,20
962000,411435,30714,30866,473015,22
962000,404054,30487,31001,465542,24
962500,405253,30500,31054,466807,22
962500,410414,30264,31162,471840,16
962500,402686,30716,31075,464477,25
962500,396532,33180,30924,460636,21
962500,401730,30718,30597,463045,30
963000,402346,30288,30517,463151,19
963000,401706,30101,31126,462933,27
963000,397314,30918,30863,459095,19
963000,404889,30883,32048,467820,19
963000,403741,30397,30361,464499,26
963500,409108,30389,30332,469829,18
963500,405302,30581,30772,466655,26
963500,400891,30108,30982,461981,23
963500,404091,30328,30174,464593,20
963500,406198,30363,31054,467615,27
964000,399979,30640,30714,461333,20
964000,404042,30520,31433,465995,29
964000,402889,30632,31422,464943,25
964000,401543,30262,30367,462172,24
964000,401748,30683,30368,462799,23
964500,445610,38432,52377,536419,28
964500,398249,29878,29951,458078,27
964500,402326,30917,30803,464046,19
964500,406078,31008,31095,468181,27
964500,406177,30318,30674,467169,26
965000,410458,30233,30500,471191,34
965000,421964,30613,30394,482971,21
965000,406398,31326,30841,468565,20
965000,400681,30210,30554,461445,21
965000,401915,31665,30342,463922,23
965500,405767,30875,30736,467378,23
965500,403071,30041,30222,463334,22
965500,399706,30588,30964,461258,17
965500,404517,31070,31030,466617,24
965500,403550,30948,30906,465404,20
966000,417157,30368,30840,478365,22
966000,403591,30913,30672,465176,23
966000,401972,30166,30405,462543,26
966000,403127,31110,31755,465992,24
966000,394343,30384,30003,454730,22
966500,404784,30176,42486,477446,25
966500,401760,30253,30453,462466,24
966500,406771,30238,30427,467436,29
966500,401099,29895,30434,461428,23
966500,401244,34385,30113,465742,24
967000,428841,33636,31149,493626,22
967000,405817,30769,30990,467576,25
967000,409215,30342,30428,469985,23
967000,416425,30098,30425,476948,23
967000,402091,32664,31194,465949,19
967500,418189,30605,30474,479268,29
967500,402979,30432,31611,465022,28
967500,411591,30171,30729,472491,19
967500,401296,32488,31031,464815,24
967500,396082,30420,30161,456663,17
968000,414605,29790,30104,474499,21
968000,407153,30970,30608,468731,19
968000,410775,30269,32478,473522,16
968000,411491,31132,32401,475024,20
968000,410535,30373,31099,472007,20
968500,407754,30414,31035,469203,22
968500,400394,30516,30564,461474,18
968500,406724,30958,30546,468228,22
968500,402030,30737,30079,462846,26
968500,428337,29881,30532,488750,24
969000,403649,31051,30906,465606,22
969000,408144,30474,30936,469554,30
969000,403948,33212,30972,468132,24
969000,403286,30872,31114,465272,17
969000,416222,30774,30477,477473,25
969500,412224,33346,32886,478456,20
969500,418038,30785,31051,479874,25
969500,402791,31480,31440,465711,21
969500,407247,30736,31153,469136,27
969500,410228,31339,30851,472418,23
970000,411775,31046,30906,473727,27
970000,408200,30385,31461,470046,29
970000,410043,30458,32328,472829,19
970000,407273,30441,30566,468280,24
970000,406251,31695,32188,470134,16
970500,418361,30661,30557,479579,27
970500,403610,30785,31866,466261,21
970500,404633,30355,30564,465552,22
970500,411001,44212,31428,486641,20
970500,405868,30649,31742,468259,24
971000,406004,30489,31133,467626,23
971000,405034,30980,32081,468095,27
971000,404346,30350,30788,465484,24
971000,408568,31428,31032,471028,24
971000,414379,32571,33243,480193,34
971500,419404,33341,31294,484039,30
971500,409409,32713,30638,472760,23
971500,399821,30229,31568,461618,17
971500,414221,30709,31060,475990,18
971500,405791,31864,32037,469692,25
972000,445513,46435,52736,544684,22
972000,399304,29975,30202,459481,24
972000,398544,30017,30174,458735,21
972000,404795,30770,32175,467740,22
972000,407709,30703,30772,469184,21
972500,402791,41555,31212,475558,26
972500,409584,31097,31015,471696,18
972500,401562,30680,31108,463350,21
972500,401143,29890,30216,461249,25
972500,400906,30597,30153,461656,21
973000,402651,31960,30650,465261,27
973000,407221,31032,31077,469330,25
973000,395221,29969,30253,455443,23
973000,421453,30621,30594,482668,24
973000,398157,30576,30527,459260,28
973500,404822,30890,30976,466688,21
973500,408743,30589,31731,471063,20
973500,431884,30648,30704,493236,27
973500,406127,30677,30768,467572,24
973500,402488,30200,30298,462986,20
974000,398278,34878,30696,463852,20
974000,398125,30427,30862,459414,28
974000,407116,30482,30744,468342,28
974000,404062,30158,30425,464645,21
974000,405492,30774,33479,469745,26
974500,404045,48751,38143,490939,22
974500,405019,30518,30949,466486,21
974500,400662,30480,30645,461787,24
974500,404072,30003,30400,464475,24
974500,419655,31382,32234,483271,28
975000,408370,30623,37031,476024,23
975000,404254,31117,30767,466138,22
975000,406732,30505,30683,467920,22
975000,457752,30714,32863,521329,24
975000,411083,31490,31267,473840,27
975500,416859,33637,36654,487150,25
975500,410958,30753,30800,472511,21
975500,419062,31052,30820,480934,24
975500,413499,31389,31606,476494,23
975500,407720,30905,30840,469465,25
976000,411537,30940,31155,473632,18
976000,413091,31499,31456,476046,25
976000,408777,31730,30943,471450,17
976000,411381,31730,30795,473906,26
976000,412184,30707,30858,473749,19
976500,409321,43205,34958,487484,26
976500,410591,30892,31475,472958,23
976500,412202,31214,31326,474742,27
976500,409755,31877,31312,472944,19
976500,412378,32250,31636,476264,23
977000,415954,34654,32101,482709,22
977000,414987,31749,31716,478452,23
977000,424967,30839,30931,486737,31
977000,413281,30672,33259,477212,28
977000,411325,31093,30852,473270,26
977500,409222,44123,34104,487449,25
977500,411630,30624,30900,473154,22
977500,413101,30611,31384,475096,24
977500,409627,31058,30982,471667,29
977500,409578,30942,31351,471871,22
978000,413222,31714,30943,475879,19
978000,412057,31070,31908,475035,26
978000,409346,34060,33205,476611,23
978000,410622,30729,30766,472117,22
978000,415200,30664,31516,477380,24
978500,422587,30647,32069,485303,30
978500,407672,30590,30466,468728,27
978500,406998,30979,30750,468727,21
978500,414807,31277,31537,477621,22
978500,407047,30827,31079,468953,19
979000,428013,31183,30542,489738,28
979000,431816,30684,31208,493708,18
979000,411482,31073,31537,474092,25
979000,407132,31743,32408,471283,21
979000,453212,31129,31618,515959,21
979500,416036,31621,31650,479307,27
979500,418367,31647,31028,481042,17
979500,409769,31292,30981,472042,17
979500,415422,31497,31220,478139,24
979500,414618,31211,31157,476986,20
980000,408383,31536,31978,471897,24
980000,412791,31825,31458,476074,30
980000,417146,30721,31462,479329,19
980000,412246,31706,31331,475283,23
980000,415708,31157,30814,477679,24
980500,419720,31461,41852,493033,24
980500,413098,35705,32549,481352,22
980500,406056,30396,31448,467900,21
980500,416189,30490,31338,478017,24
980500,417615,32009,30569,480193,32
981000,414138,30769,31104,476011,16
981000,405543,30425,32336,468304,21
981000,414491,32935,30765,478191,25
981000,415524,31339,31427,478290,22
981000,420213,31302,31200,482715,21
981500,416739,33501,33282,483522,18
981500,412430,32049,32079,476558,21
981500,416048,31448,31122,478618,21
981500,417522,31931,31059,480512,22
981500,424264,31804,31874,487942,14
982000,431594,32790,31467,495851,18
982000,415456,32283,32435,480174,20
982000,416809,31132,31073,479014,28
982000,406147,30574,36066,472787,27
982000,409621,30522,31961,472104,28
982500,406069,31033,30983,468085,21
982500,402262,31895,31881,466038,28
982500,415244,31604,31709,478557,25
982500,415413,30812,33299,479524,27
982500,409095,30918,30882,470895,28
983000,409797,35780,52496,498073,24
983000,415886,31414,31506,478806,26
983000,414008,30906,31845,476759,22
983000,416607,31675,31349,479631,21
983000,413595,32333,32167,478095,28
983500,419800,35616,42515,497931,25
983500,430344,31408,31732,493484,29
983500,414088,31078,31088,476254,24
983500,424067,30887,31286,486240,28
983500,418064,31901,32123,482088,24
984000,412629,32242,31379,476250,18
984000,412021,30794,30815,473630,22
984000,412550,30838,31197,474585,24
984000,440779,30512,31089,502380,27
984000,434082,30517,30730,495329,24
984500,425383,32090,31664,489137,27
984500,423736,31381,32589,487706,24
984500,411197,31521,31080,473798,22
984500,413553,31423,31177,476153,21
984500,409224,32728,31449,473401,24
985000,415991,44069,33265,493325,25
985000,415993,31521,31567,479081,22
985000,426681,31255,31909,489845,26
985000,415243,31148,31092,477483,25
985000,419853,31550,31855,483258,27
985500,410049,31795,42349,484193,24
985500,416599,32400,30725,479724,22
985500,416227,31573,31847,479647,24
985500,418314,31514,31614,481442,26
985500,414969,32220,31357,478546,29
986000,414569,31966,32440,478975,17
986000,423183,31154,31194,485531,25
986000,419190,32303,31743,483236,24
986000,416177,31394,31903,479474,25
986000,415659,31572,32013,479244,21
986500,417524,38398,33567,489489,25
986500,417220,32022,34439,483681,24
986500,422030,31223,31812,485065,19
986500,418147,31002,31413,480562,23
986500,413224,32393,31720,477337,27
987000,423799,31177,31227,486203,26
987000,416758,31482,31235,479475,29
987000,415958,31192,32373,479523,25
987000,417173,31392,31614,480179,19
987000,411938,35101,33500,480539,28
987500,417292,31697,31592,480581,21
987500,415795,31381,31514,478690,24
987500,409218,31521,31904,472643,24
987500,419000,31398,32432,482830,20
987500,417624,31023,31534,480181,22
988000,412605,31431,31581,475617,20
988000,420741,31642,31671,484054,20
988000,416936,31289,32116,480341,28
988000,419071,31705,31856,482632,24
988000,417041,32852,34438,484331,17
988500,424764,31755,31255,487774,30
988500,423995,31957,31893,487845,21
988500,415332,31779,31461,478572,25
988500,413364,31939,31884,477187,27
988500,422161,30989,31863,485013,26
989000,412384,31256,31737,475377,21
989000,434903,31297,32052,498252,24
989000,416644,31842,32611,481097,19
989000,416812,31813,31378,480003,19
989000,414290,30911,32102,477303,25
989500,422623,32412,42164,497199,24
989500,406097,31188,31116,468401,23
989500,416239,31847,33264,481350,21
989500,415199,31822,31780,478801,25
989500,417226,31544,32475,481245,24
990000,417150,33859,45406,496415,24
990000,417698,32065,31318,481081,21
990000,416371,31880,32433,480684,22
990000,421707,31208,31813,484728,20
990000,419795,31608,31639,483042,23
990500,413767,31152,31606,476525,21
990500,408175,30896,32521,471592,28
990500,417213,30789,31113,479115,21
990500,416107,32409,31974,480490,20
990500,422103,32079,32482,486664,27
991000,432457,31936,32063,496456,27
991000,418285,31540,31464,481289,26
991000,419193,31730,31581,482504,28
991000,418115,31106,31374,480595,26
991000,421492,31617,31827,484936,24
991500,426704,35881,39471,502056,20
991500,428350,31068,31596,491014,20
991500,428064,31410,31569,491043,24
991500,416254,30925,32135,479314,23
991500,432603,31082,30805,494490,17
992000,419388,31780,31925,483093,24
992000,415145,31326,32560,479031,24
992000,407775,30896,32917,471588,22
992000,413848,32871,32521,479240,19
992000,423504,31696,32441,487641,27
992500,419052,32599,32212,483863,22
992500,415541,30712,31053,477306,20
992500,421349,32151,31779,485279,22
992500,415175,31379,31525,478079,19
992500,431931,31086,31276,494293,30
993000,437635,31160,31397,500192,27
993000,415780,31242,32200,479222,23
993000,419863,32409,31480,483752,23
993000,423224,32327,42666,498217,24
993000,424912,31447,32006,488365,21
993500,431734,30934,31009,493677,26
993500,413096,30815,35116,479027,22
993500,408041,33921,40119,482081,24
993500,413139,31702,33021,477862,24
993500,449867,30854,31117,511838,20
994000,440216,30914,31401,502531,20
994000,422012,32413,32078,486503,23
994000,470885,32996,33735,537616,26
994000,422626,30754,31103,484483,22
994000,419509,31430,31328,482267,25
994500,414678,32164,39600,486442,24
994500,414744,31182,31802,477728,21
994500,422827,31469,31401,485697,23
994500,421090,30849,31694,483633,23
994500,419772,32265,31059,483096,20
995000,432076,30929,31710,494715,26
995000,417643,32086,32165,481894,23
995000,421832,31794,31402,485028,25
995000,417618,32042,31707,481367,23
995000,420775,31710,31596,484081,20
995500,422473,31242,31840,485555,20
995500,420136,31946,32010,484092,21
995500,418306,33675,31406,483387,23
995500,418743,31273,31592,481608,20
995500,422609,32783,31112,486504,25
996000,421132,33571,32232,486935,27
996000,423196,32592,31348,487136,23
996000,414138,32198,32161,478497,21
996000,418470,32153,32346,482969,21
996000,459086,31031,31312,521429,24
996500,418410,32291,33266,483967,24
996500,421394,32125,32277,485796,19
996500,416478,39542,31998,488018,26
996500,420315,31587,31927,483829,30
996500,420126,32000,32488,484614,28
997000,418074,31976,31981,482031,19
997000,421033,32072,32239,485344,21
997000,427262,31263,31584,490109,21
997000,422059,32201,32068,486328,26
997000,421190,32392,34238,487820,21
997500,421884,31554,31631,485069,21
997500,420048,31749,32534,484331,26
997500,424228,32236,34171,490635,25
997500,418074,31786,32050,481910,23
997500,442704,32026,32766,507496,25
998000,427377,33297,48610,509284,23
998000,444723,33097,31175,508995,19
998000,447727,33631,31146,512504,22
998000,410112,32605,34103,476820,22
998000,421582,31208,31453,484243,26
998500,452308,30806,31058,514172,27
998500,448228,33489,32076,513793,20
998500,410346,31473,44932,486751,25
998500,432013,37201,31907,501121,19
998500,414946,31618,31648,478212,26
999000,417662,34997,36641,489300,22
999000,426705,35248,40846,502799,33
999000,438771,30869,31419,501059,23
999000,410427,32041,32649,475117,18
999000,412085,31978,31082,475145,24
999500,426085,30912,31102,488099,28
999500,410908,30898,34505,476311,24
999500,412791,32658,31455,476904,23
999500,423277,46992,32638,502907,26
999500,416885,31667,31997,480549,19
1000000,411438,30822,31218,473478,22
1000000,408632,30873,31298,470803,28
1000000,413479,30834,31069,475382,22
1000000,410994,31610,31764,474368,32
1000000,415116,31222,31445,477783,23
1000500,414615,31701,31554,477870,21
1000500,416982,31055,31089,479126,28
1000500,408688,30951,31370,471009,25
